20160620,309,315,300,301,983356,301667968,547104,-8,-2.59 ,500.00 ,476518,506838
20160617,331,335,300,310,3995028,1248615680,577424,-21,-6.34 ,1166.67 ,2084766,1910262
20160616,327,340,310,331,4599984,1493669888,402920,4,1.22 ,967.74 ,2219506,2380478
20160615,337,340,321,327,4024470,1320912640,563892,-10,-2.97 ,591.90 ,1921306,2103164
20160614,348,355,334,336,3805222,1304871936,745750,-12,-3.45 ,628.74 ,1885412,1919810
20160613,370,375,343,348,5248954,1878243712,780148,-22,-5.95 ,932.94 ,2832724,2416230
20160612,365,371,350,370,2821966,1016184128,363654,5,1.37 ,600.00 ,1387502,1434464
20160608,363,369,349,365,2897986,1038311616,410616,2,0.55 ,573.07 ,1463503,1434483
20160607,372,374,358,363,2815502,1026077376,381596,-9,-2.42 ,446.93 ,1406591,1408911
20160606,384,400,368,372,2783088,1074309632,383916,-12,-3.13 ,869.57 ,1328311,1454777
20160603,367,387,358,384,3468178,1308582400,510382,17,4.63 ,810.06 ,1732180,1735998
20160602,355,369,352,367,3217694,1167469312,514200,12,3.38 ,482.95 ,1639547,1578147
20160601,332,357,331,355,3217070,1119297920,452800,23,6.93 ,785.50 ,1574294,1642776
20160531,336,343,328,332,2362750,791059904,521282,-4,-1.19 ,457.32 ,1177358,1185392
20160530,319,338,315,336,3223062,1051218368,529316,17,5.33 ,730.16 ,1711341,1511721
20160527,318,325,314,319,2434540,777434048,329696,1,0.31 ,350.32 ,1212563,1221977
20160526,316,325,314,318,2325074,742464000,339110,2,0.63 ,350.32 ,1159601,1165473
20160525,305,319,300,316,3141110,976752640,344982,11,3.61 ,633.33 ,1564638,1576472
20160524,295,311,286,305,3421664,1021778624,356816,10,3.39 ,874.13 ,1693721,1727943
20160523,310,313,291,295,3650740,1091405056,391038,-15,-4.84 ,756.01 ,1838374,1812366
20160520,311,318,305,310,3120694,971240768,365030,-1,-0.32 ,426.23 ,1563560,1557134
20160519,300,312,289,311,3285878,990399104,358604,11,3.67 ,795.85 ,1621370,1664508
20160518,294,301,284,300,3685120,1076097664,401742,6,2.04 ,598.59 ,1825578,1859542
20160517,312,316,290,294,4923890,1475120128,435706,-18,-5.77 ,896.55 ,2475630,2448260
20160516,309,315,295,312,4316852,1310423552,408336,3,0.97 ,677.97 ,2154229,2162623
20160504,348,353,333,336,1539128,524051200,416730,-12,-3.45 ,600.60 ,790504,748624
20160503,357,361,341,348,3269038,1135083264,374850,-9,-2.52 ,586.51 ,1639974,1629064
20160429,348,362,334,357,3368878,1174179200,363940,9,2.59 ,838.32 ,1596936,1771942
20160428,360,361,345,348,3162006,1114189568,538946,-12,-3.33 ,463.77 ,1608993,1553013
20160427,380,383,357,360,3987184,1474508032,482966,-20,-5.26 ,728.29 ,1991480,1995704
20160426,398,401,379,380,3172430,1219622016,487190,-18,-4.52 ,580.47 ,1591503,1580927
20160425,425,429,394,397,3738006,1535772416,476614,-28,-6.59 ,888.32 ,1911998,1826008
20160422,399,427,396,425,2781464,1139015680,390624,26,6.52 ,782.83 ,1378719,1402745
20160421,410,423,393,399,3079150,1257057280,414650,-11,-2.68 ,763.36 ,1560872,1518278
20160420,389,412,388,410,3523416,1416556160,372056,21,5.40 ,618.56 ,1759299,1764117
20160419,391,397,374,389,3853384,1480779008,376874,-2,-0.51 ,614.97 ,1908974,1944410
20160418,383,393,368,391,3397252,1294848384,412310,8,2.09 ,679.35 ,1694577,1702675
20160415,398,402,377,383,3826118,1474263424,420408,-15,-3.77 ,663.13 ,1848016,1978102
20160414,423,425,395,398,4295812,1740457728,550494,-25,-5.91 ,759.49 ,2167439,2128373
20160413,422,431,412,423,4012786,1690300160,511428,1,0.24 ,461.17 ,2012879,1999907
20160412,457,463,418,422,4648892,2067608448,498456,-35,-7.66 ,1076.56 ,2356723,2292169
20160411,451,460,433,457,3888462,1727112960,433902,6,1.33 ,623.56 ,1935584,1952878
20160408,472,475,448,451,3932782,1795828480,451196,-21,-4.45 ,602.68 ,1946795,1985987
20160407,497,498,469,472,3953478,1892536320,490388,-25,-5.03 ,618.34 ,1974557,1978921
20160406,535,539,494,497,5384774,2728991488,494752,-38,-7.10 ,910.93 ,2725195,2659579
20160405,525,547,521,535,4227278,2255628288,429136,10,1.90 ,499.04 ,2141114,2086164
20160401,546,553,523,525,4773330,2574649856,374186,-21,-3.85 ,573.61 ,2380562,2392768
20160331,541,552,528,546,3793364,2045386880,386392,5,0.92 ,454.55 ,1900967,1892397
20160330,511,549,508,541,4071380,2185357568,377822,30,5.87 ,807.09 ,2010756,2060624
20160329,511,526,506,511,3650330,1891006976,427690,0,0.00 ,395.26 ,1825528,1824802
20160328,488,515,485,511,3710860,1865486976,426964,23,4.71 ,618.56 ,1840180,1870680
20160325,471,492,465,488,4523132,2187706112,457464,17,3.61 ,580.65 ,2217232,2305900
20160324,441,477,425,471,5841134,2672833536,546132,30,6.80 ,1223.53 ,3003205,2837929
20160323,465,470,435,441,3120364,1407217792,380856,-24,-5.16 ,804.60 ,1557471,1562893
20160322,462,466,446,465,3141764,1431256960,386278,3,0.65 ,448.43 ,1581382,1560382
20160321,453,464,441,462,2696394,1219053568,365278,9,1.99 ,521.54 ,1353756,1342638
20160318,472,475,449,453,3415704,1571527296,354160,-19,-4.03 ,579.06 ,1609448,1806256
20160317,512,513,468,472,4050194,1962937088,550968,-40,-7.81 ,961.54 ,2061867,1988327
20160316,486,520,483,511,2364012,1200565248,477428,25,5.14 ,766.05 ,1265096,1098916
20160315,494,510,483,486,1913696,949580608,311248,-8,-1.62 ,559.01 ,938209,975487
20160314,466,496,465,494,2084932,1000658688,348526,28,6.01 ,666.67 ,1038600,1046332
20160311,467,486,461,465,3175118,1507671808,356258,-2,-0.43 ,542.30 ,1591481,1583637
20160310,451,474,450,467,2197798,1022228160,348414,16,3.55 ,533.33 ,1066532,1131266
20160309,438,455,435,451,1998398,895943488,413148,13,2.97 ,459.77 ,974908,1023490
20160308,410,443,397,439,2642784,1120740096,461730,29,7.07 ,1158.69 ,1387900,1254884
20160307,418,435,410,410,2004714,847457280,328714,-8,-1.91 ,609.76 ,988796,1015918
20160304,425,440,416,418,2240454,956847104,355836,-7,-1.65 ,576.92 ,1111623,1128831
20160303,405,428,401,425,2294044,952529536,373044,20,4.94 ,673.32 ,1145974,1148070
20160302,384,408,383,405,2242004,894864256,375140,21,5.47 ,652.74 ,1117202,1124802
20160301,370,389,367,385,2121014,806122752,382740,15,4.05 ,599.46 ,1079173,1041841
20160229,356,375,345,370,2272248,825477376,345408,14,3.93 ,869.57 ,1147116,1125132
20160226,351,360,340,356,1778620,624030656,323424,5,1.42 ,588.24 ,904378,874242
20160225,346,353,339,351,1724108,598620672,293288,5,1.45 ,412.98 ,857469,866639
20160224,370,372,342,346,1508238,536019680,302458,-24,-6.49 ,877.19 ,749821,758417
20160223,366,373,352,371,1312498,474147264,311054,5,1.37 ,596.59 ,657049,655449
20160219,385,385,364,366,1442496,537001600,309454,-19,-4.94 ,576.92 ,723948,718548
20160218,406,408,382,384,1830882,720828352,304054,-22,-5.42 ,680.63 ,913486,917396
20160217,420,422,403,406,1248612,513850304,307964,-14,-3.33 ,471.46 ,624013,624599
20160216,450,455,416,421,1665170,722672320,308550,-29,-6.44 ,937.50 ,848512,816658
20160215,437,451,435,450,1507566,669574912,276696,13,2.97 ,367.82 ,742979,764587
20160214,435,447,429,438,1452268,635472640,298304,3,0.69 ,419.58 ,710616,741652
20160206,429,446,427,436,1458366,636579776,329340,7,1.63 ,444.96 ,749184,709182
20160205,410,434,407,428,1562146,656882688,289338,18,4.39 ,663.39 ,786055,776091
20160204,421,423,400,409,1429368,587783104,279374,-12,-2.85 ,575.00 ,712748,716620
20160203,433,439,416,422,1085824,463799616,283246,-11,-2.54 ,552.88 ,543524,542300
20160202,432,449,427,434,1410434,619098112,282022,2,0.46 ,515.22 ,698446,711988
20160201,425,437,418,432,1062362,452674432,295564,7,1.65 ,454.55 ,540228,522134
20160129,439,444,418,425,1040958,445612288,277470,-14,-3.19 ,622.01 ,520385,520573
20160128,458,461,435,438,1079836,479726496,277658,-20,-4.37 ,597.70 ,532954,546882
20160127,486,490,451,458,1259374,588944384,291586,-28,-5.76 ,864.75 ,638083,621291
20160126,492,498,478,486,927400,453286432,274794,-6,-1.22 ,418.41 ,453569,473831
20160125,480,497,477,491,942030,459215904,295056,11,2.29 ,419.29 ,475357,466673
20160122,462,486,455,480,1038278,493773344,286372,18,3.90 ,681.32 ,518694,519584
20160121,435,466,430,462,1607766,732458176,287262,27,6.21 ,837.21 ,799579,808187
20160120,436,443,426,434,1163366,506269888,295870,-2,-0.46 ,399.06 ,593107,570259
20160119,422,439,417,435,1074564,458546656,273022,13,3.08 ,527.58 ,535596,538968
20160118,425,430,414,421,1102584,464372960,276394,-4,-0.94 ,386.47 ,539095,563489
20160115,436,444,420,425,1209588,522370752,300788,-11,-2.52 ,571.43 ,611659,597929
20160114,425,441,420,436,1128886,485103680,287058,11,2.59 ,500.00 ,565213,563673
20160113,423,430,413,425,1019302,430807296,285518,2,0.47 ,411.62 ,514621,504681
20160112,412,429,403,423,1291182,534031648,275578,11,2.67 ,645.16 ,647617,643565
20160111,403,416,393,411,1142492,460968192,271526,8,1.99 ,585.24 ,568311,574181
20160108,397,411,390,403,1153028,461497120,277396,6,1.51 ,538.46 ,580901,572127
20160107,393,413,383,407,879296,348490240,268622,14,3.56 ,783.29 ,442374,436922
20160106,399,410,385,393,791538,315112128,263170,-6,-1.50 ,649.35 ,393301,398237
20160105,386,406,382,398,620446,243948256,268106,12,3.11 ,628.27 ,302053,318393
20160104,386,397,380,386,406234,157769776,284446,0,0.00 ,447.37 ,208088,198146
20151231,379,386,375,386,172894,65573484,274504,7,1.85 ,293.33 ,86105,86789
20151230,378,387,376,379,239130,91004392,275188,1,0.26 ,292.55 ,118284,120846
20151229,359,381,359,378,218622,81935504,277750,19,5.29 ,612.81 ,109617,109005
20151228,358,369,356,368,199592,72573640,277138,10,2.79 ,365.17 ,99507,100085
20151225,351,360,348,358,198988,70556928,277716,7,1.99 ,344.83 ,99187,99801
20151224,344,351,337,351,220116,75638784,278330,7,2.03 ,415.43 ,109414,110702
20151223,351,353,343,344,163038,56553520,279618,-7,-1.99 ,291.55 ,81681,81357
20151222,349,355,346,351,174986,61297720,279294,2,0.57 ,260.12 ,87415,87571
20151221,343,351,341,349,299134,103512504,279450,6,1.75 ,293.26 ,149217,149917
20151218,347,354,343,343,303166,105424352,280150,-4,-1.15 ,320.70 ,151876,151290
20151217,353,357,347,347,284064,99689760,279564,-6,-1.70 ,288.18 ,142026,142038
20151216,350,357,347,353,322500,113626112,279576,3,0.86 ,288.18 ,161414,161086
20151215,348,354,342,350,228360,79324896,279248,2,0.57 ,350.88 ,113878,114482
20151214,353,355,346,348,194934,68324960,279852,-5,-1.42 ,260.12 ,97283,97651
20151211,356,360,353,353,197650,70444232,280220,-3,-0.84 ,198.30 ,99107,98543
20151210,350,357,345,356,223256,78337264,279656,6,1.71 ,347.83 ,111487,111769
20151209,348,356,344,350,214508,75000512,279938,2,0.57 ,348.84 ,107052,107456
20151208,355,357,348,348,181694,63897636,280342,-7,-1.97 ,258.62 ,89413,92281
20151207,357,360,352,355,205816,73334112,283210,-2,-0.56 ,227.27 ,102810,103006
20151204,359,362,355,357,214068,76755048,283406,-2,-0.56 ,197.18 ,107243,106825
20151203,367,369,359,359,228752,83237384,282988,-8,-2.18 ,278.55 ,114750,114002
20151202,376,377,367,367,276018,102495696,282240,-9,-2.39 ,272.48 ,138512,137506
20151201,367,377,366,376,276990,103032216,281234,9,2.45 ,300.55 ,138275,138715
20151130,366,371,361,367,265658,97276960,281674,1,0.27 ,277.01 ,132560,133098
20151127,367,375,366,366,299616,110877608,282212,-1,-0.27 ,245.90 ,149433,150183
20151126,361,370,360,367,256318,93800376,282962,6,1.66 ,277.78 ,128160,128158
20151125,362,363,350,361,292918,104339240,282960,-1,-0.28 ,371.43 ,145654,147264
20151124,363,369,358,358,316206,115184664,284570,-5,-1.38 ,307.26 ,157395,158811
20151123,363,367,357,363,244376,88506376,285986,0,0.00 ,280.11 ,122724,121652
20151120,364,371,362,363,268608,98542736,284914,-1,-0.27 ,248.62 ,134101,134507
20151119,365,372,363,364,260168,95666816,285320,-1,-0.27 ,247.93 ,130094,130074
20151118,367,368,360,365,321086,116937192,285300,-2,-0.54 ,222.22 ,159826,161260
20151117,360,368,358,367,307084,111488304,286734,7,1.94 ,279.33 ,153524,153560
20151116,355,363,354,360,282300,101393656,286770,5,1.41 ,254.24 ,141072,141228
20151113,347,356,345,355,294846,103818672,286926,8,2.31 ,318.84 ,147359,147487
20151112,350,353,344,347,294200,102402336,287054,-3,-0.86 ,261.63 ,147653,146547
20151111,348,354,345,350,299438,104714144,285948,2,0.57 ,260.87 ,149477,149961
20151110,339,349,338,348,323888,111433336,286432,9,2.65 ,325.44 ,161776,162112
20151109,332,340,328,339,262362,88035168,286768,7,2.11 ,365.85 ,130161,132201
20151106,334,339,330,332,311210,104051712,288808,-2,-0.60 ,272.73 ,156146,155064
20151105,327,336,326,334,281932,93505056,287726,7,2.14 ,306.75 ,140684,141248
20151104,327,333,324,327,298808,98429376,288290,0,0.00 ,277.78 ,148981,149827
20151103,328,334,327,327,314228,103744824,289136,-1,-0.30 ,214.07 ,156478,157750
20151102,330,333,327,328,290472,95762512,290408,-2,-0.61 ,183.49 ,145619,144853
20151030,323,334,322,330,303218,99750608,289642,7,2.17 ,372.67 ,150246,152972
20151029,322,329,321,323,333806,108792928,292368,1,0.31 ,249.22 ,167567,166239
20151028,323,329,321,322,332642,107982920,291040,-1,-0.31 ,249.22 ,166395,166247
20151027,331,333,324,324,291522,95688424,290892,-7,-2.11 ,277.78 ,145616,145906
20151026,326,334,325,331,364508,120301936,291182,5,1.53 ,276.92 ,182025,182483
20151023,323,329,320,326,296366,96166944,291640,3,0.93 ,281.25 ,148162,148204
20151022,316,323,314,323,308244,98280312,291682,7,2.22 ,286.62 ,153807,154437
20151021,317,319,311,316,327750,103109296,292312,-1,-0.32 ,257.23 ,163176,164574
20151020,313,317,309,317,319012,100014736,293710,4,1.28 ,258.90 ,159140,159872
20151019,312,315,307,313,284724,88674752,294442,1,0.32 ,260.59 ,141753,142971
20151016,311,316,310,312,242182,75838016,295660,1,0.32 ,193.55 ,121979,120203
20151015,309,313,305,311,241026,74519176,293884,2,0.65 ,262.30 ,119546,121480
20151014,305,311,302,309,265950,81450704,295818,4,1.31 ,298.01 ,132944,133006
20151013,313,315,305,305,219700,68099720,295880,-8,-2.56 ,327.87 ,110371,109329
20151012,308,317,307,313,203212,63398052,294838,5,1.62 ,325.73 ,101542,101670
20151010,309,314,307,308,196886,61075040,294966,-1,-0.32 ,228.01 ,98352,98534
20151009,303,311,301,309,243298,74271344,295148,6,1.98 ,332.23 ,120177,123121
20151008,302,309,300,303,193366,59099172,298092,1,0.33 ,300.00 ,96695,96671
20150930,306,308,299,302,183038,55506368,298068,-4,-1.31 ,301.00 ,90425,92613
20150929,308,310,302,306,194578,59502616,300256,-2,-0.65 ,264.90 ,97641,96937
20150928,304,312,303,308,155056,47726384,299552,4,1.32 ,297.03 ,77348,77708
20150925,295,304,294,304,175998,52761084,299912,9,3.05 ,340.14 ,87594,88404
20150924,286,295,284,295,182862,53188216,300722,9,3.15 ,387.32 ,90792,92070
20150923,290,293,285,286,169930,49061448,302000,-4,-1.38 ,280.70 ,84831,85099
20150922,289,291,283,290,211244,60622020,302268,1,0.35 ,282.69 ,105729,105515
20150921,287,291,282,289,203386,58218796,302054,2,0.70 ,319.15 ,101445,101941
20150918,286,288,281,287,201254,57237328,302550,1,0.35 ,249.11 ,100326,100928
20150917,293,295,285,286,188032,54261820,303152,-7,-2.39 ,350.88 ,94333,93699
20150916,302,305,293,293,235164,70182960,302518,-9,-2.98 ,409.56 ,117648,117516
20150915,312,315,302,302,238018,73193312,302386,-10,-3.21 ,430.46 ,119865,118153
20150914,308,312,303,312,183272,56435380,300674,4,1.30 ,297.03 ,90225,93047
20150911,305,310,301,308,259586,79411232,303496,3,0.98 ,299.00 ,132066,127520
20150910,296,301,292,301,101516,30087912,298950,5,1.69 ,308.22 ,50229,51287
20150909,304,307,296,296,197380,59395696,300008,-8,-2.63 ,371.62 ,98644,98736
20150908,305,308,301,304,230032,70023208,300100,-1,-0.33 ,232.56 ,114663,115369
20150907,307,309,301,305,240604,73368944,300806,-2,-0.65 ,265.78 ,119843,120761
20150906,306,313,303,305,115638,35653252,301724,-1,-0.33 ,330.03 ,57871,57767
20150902,307,314,304,306,194498,60290476,301620,-1,-0.33 ,328.95 ,97233,97265
20150901,298,307,296,303,215462,64963820,301652,5,1.68 ,371.62 ,107823,107639
20150831,299,307,295,298,216318,65420188,301468,-1,-0.33 ,406.78 ,107472,108846
20150828,288,297,287,296,154824,45418208,302842,8,2.78 ,348.43 ,77032,77792
20150827,275,288,275,288,290452,82468944,303602,13,4.73 ,472.73 ,144934,145518
20150826,270,278,264,275,245230,66365472,304186,5,1.85 ,530.30 ,119810,125420
20150825,268,272,261,270,330132,88249904,309796,2,0.75 ,421.46 ,165338,164794
20150824,265,270,262,265,127542,33967880,309252,0,0.00 ,305.34 ,63991,63551
20150821,264,266,255,265,232540,60404596,308812,1,0.38 ,431.37 ,116313,116227
20150820,272,276,264,264,253178,68364144,308726,-8,-2.94 ,454.55 ,127729,125449
20150819,266,276,265,272,280914,75996488,306446,6,2.26 ,415.09 ,140218,140696
20150818,278,279,267,269,199480,54310504,306924,-9,-3.24 ,449.44 ,100597,98883
20150817,288,291,278,278,297330,84597704,305210,-10,-3.47 ,467.63 ,149739,147591
20150814,290,293,283,288,283432,81506976,303062,-2,-0.69 ,353.36 ,141860,141572
20150813,292,296,288,290,261282,76274224,302774,-2,-0.68 ,277.78 ,130729,130553
20150812,281,292,279,292,238386,68534240,302598,11,3.91 ,465.95 ,118530,119856
20150811,280,284,272,281,215660,59959036,303924,1,0.36 ,441.18 ,106954,108706
20150810,278,285,275,280,234468,65768060,305676,2,0.72 ,363.64 ,117763,116705
20150807,289,290,277,278,189646,53548952,304618,-11,-3.81 ,469.31 ,94480,95166
20150806,288,293,285,289,208394,60282164,305304,1,0.35 ,280.70 ,104218,104176
20150805,292,295,286,289,290204,84235232,305262,-3,-1.03 ,314.69 ,145068,145136
20150804,292,295,287,293,274754,80038880,305330,1,0.34 ,278.75 ,137034,137720
20150803,294,297,288,292,277774,81214384,306016,-2,-0.68 ,312.50 ,139345,138429
20150731,286,294,282,294,231296,66627308,305100,8,2.80 ,425.53 ,115365,115931
20150730,293,295,284,286,279390,80775080,305666,-7,-2.39 ,387.32 ,139239,140151
20150729,305,308,293,293,234604,70028520,306578,-12,-3.93 ,511.95 ,118969,115635
20150728,298,305,293,303,224286,67148304,303244,5,1.68 ,409.56 ,111862,112424
20150727,293,301,290,298,233638,69212776,303806,5,1.71 ,379.31 ,116930,116708
20150724,297,298,289,293,277846,81421424,303584,-4,-1.35 ,311.42 ,139046,138800
20150723,298,298,290,297,263438,77507344,303338,-1,-0.34 ,275.86 ,131554,131884
20150722,301,308,300,301,131818,40047040,303668,0,0.00 ,266.67 ,66603,65215
20150721,295,305,293,301,260368,78061792,302280,6,2.03 ,409.56 ,130166,130202
20150720,296,300,293,295,262868,77919688,302316,-1,-0.34 ,238.91 ,131273,131595
20150717,292,300,292,296,282316,83597992,302638,4,1.37 ,273.97 ,141090,141226
20150716,298,302,291,292,298566,88507528,302774,-6,-2.01 ,378.01 ,149523,149043
20150715,291,299,286,298,267872,78303272,302294,7,2.41 ,454.55 ,133321,134551
20150714,284,292,281,291,272184,78117776,303524,7,2.46 ,391.46 ,135976,136208
20150713,278,287,273,284,297654,83355760,303756,6,2.16 ,512.82 ,148287,149367
20150710,287,291,277,278,300948,85341112,304836,-9,-3.14 ,505.42 ,149856,151092
20150709,293,297,287,287,279758,81667440,306072,-6,-2.05 ,348.43 ,140501,139257
20150708,292,295,287,293,299336,86928104,304828,1,0.34 ,278.75 ,149254,150082
20150707,307,308,292,292,308968,92395432,305656,-15,-4.89 ,547.95 ,155092,153876
20150706,306,309,299,307,292358,88923136,304440,1,0.33 ,334.45 ,146402,145956
20150703,313,315,305,306,217202,67179344,303994,-7,-2.24 ,327.87 ,108388,108814
20150702,315,316,307,313,292244,90978608,304420,-2,-0.63 ,293.16 ,146083,146161
20150701,317,319,310,315,295188,92683776,304498,-2,-0.63 ,290.32 ,147424,147764
20150630,312,319,311,317,249084,78513568,304838,5,1.60 ,257.23 ,125429,123655
20150629,303,312,301,312,320710,98271480,303064,9,2.97 ,365.45 ,160275,160435
20150626,301,306,298,303,362668,109583808,303224,2,0.66 ,268.46 ,181074,181594
20150625,311,312,300,301,245176,74800136,303744,-10,-3.22 ,400.00 ,122476,122700
20150624,316,318,308,311,308524,96600824,303968,-5,-1.58 ,324.68 ,155745,152779
20150623,312,318,310,316,236384,74375072,301002,4,1.28 ,258.06 ,118734,117650
20150619,315,319,310,312,353072,110985728,299918,-3,-0.95 ,290.32 ,178021,175051
20150618,314,316,307,315,395572,123207272,296948,1,0.32 ,293.16 ,196528,199044
20150617,324,325,313,314,391048,124214608,299464,-10,-3.09 ,383.39 ,195205,195843
20150616,335,335,324,324,307890,101204888,300102,-11,-3.28 ,339.51 ,152087,155803
20150615,341,342,333,335,236984,79906480,303818,-6,-1.76 ,270.27 ,118214,118770
20150612,339,343,336,341,370634,125724664,304374,2,0.59 ,208.33 ,185154,185480
20150611,343,345,338,339,215892,73736712,304700,-4,-1.17 ,207.10 ,107696,108196
20150610,347,348,341,343,217088,74853280,305200,-4,-1.15 ,205.28 ,108571,108517
20150609,349,350,342,347,269836,93292336,305146,-2,-0.57 ,233.92 ,134762,135074
20150608,354,356,347,349,251362,88412944,305458,-5,-1.41 ,259.37 ,125287,126075
20150605,353,355,348,354,386232,135718720,306246,1,0.28 ,201.15 ,193470,192762
20150604,352,357,350,353,426820,150720096,305538,1,0.28 ,200.00 ,216741,210079
20150603,350,355,347,352,417080,146731136,298876,2,0.57 ,230.55 ,213391,203689
20150602,353,354,347,350,278550,97551400,289174,-3,-0.85 ,201.73 ,139384,139166
20150601,353,354,347,353,250970,87982384,288956,0,0.00 ,201.73 ,125683,125287
20150529,360,361,351,353,327262,116101720,288560,-7,-1.94 ,284.90 ,164180,163082
20150528,365,366,356,360,324878,117095928,287462,-5,-1.37 ,280.90 ,163359,161519
20150527,369,371,363,366,392176,143380240,285622,-3,-0.81 ,220.39 ,197685,194491
20150526,375,375,367,369,328522,121763664,282428,-6,-1.60 ,217.98 ,164772,163750
20150525,381,383,373,375,375980,141902752,281406,-6,-1.57 ,268.10 ,190776,185204
20150522,379,383,375,381,339938,128735032,275834,2,0.53 ,213.33 ,169923,170015
20150521,384,388,376,379,335182,128101776,275926,-5,-1.30 ,319.15 ,167472,167710
20150520,381,387,379,384,367240,140884048,276164,3,0.79 ,211.08 ,182863,184377
20150519,377,381,374,381,360930,136436096,277678,4,1.06 ,187.17 ,180372,180558
20150518,370,377,368,377,426468,159380192,277864,7,1.89 ,244.57 ,212694,213774
20150515,368,372,364,370,414756,152699392,278944,2,0.54 ,219.78 ,207009,207747
20150514,377,377,365,368,375450,138971584,279682,-9,-2.39 ,328.77 ,187302,188148
20150513,385,386,375,377,395056,150061376,280528,-8,-2.08 ,293.33 ,197952,197104
20150512,384,388,379,385,379590,145506688,279680,1,0.26 ,237.47 ,188064,191526
20150511,381,384,377,384,421342,160406496,283142,3,0.79 ,185.68 ,211382,209960
20150508,385,386,378,381,389524,148941584,281720,-4,-1.04 ,211.64 ,194505,195019
20150507,382,385,378,385,384490,146951040,282234,3,0.79 ,185.19 ,191822,192668
20150506,381,382,373,382,425336,160690000,283080,1,0.26 ,241.29 ,213306,212030
20150505,389,390,379,381,438982,169028544,281804,-8,-2.06 ,290.24 ,219779,219203
20150504,385,389,379,389,451418,173044304,281228,4,1.04 ,263.85 ,225142,226276
20150430,380,385,377,385,430898,164437504,282362,5,1.32 ,212.20 ,215615,215283
20150429,386,387,377,380,426382,162648592,282030,-6,-1.55 ,265.25 ,213334,213048
20150428,389,390,383,386,333854,128939760,281744,-3,-0.77 ,182.77 ,166263,167591
20150427,388,389,382,389,333606,128495936,283072,1,0.26 ,183.25 ,166150,167456
20150424,386,388,382,388,310026,119351560,284378,2,0.52 ,157.07 ,154793,155233
20150423,384,386,380,386,303826,116354392,284818,2,0.52 ,157.89 ,152236,151590
20150422,394,394,383,384,254782,98777760,284172,-10,-2.54 ,287.21 ,126989,127793
20150421,403,404,392,394,294298,117008344,284976,-9,-2.23 ,306.12 ,147555,146743
20150420,402,404,396,403,327944,131166104,284164,1,0.25 ,202.02 ,164308,163636
20150417,395,402,392,402,335578,133467664,283492,7,1.77 ,255.10 ,167081,168497
20150416,401,402,393,395,336936,134216408,284908,-6,-1.50 ,229.01 ,168084,168852
20150415,407,409,397,401,343998,138574432,285676,-6,-1.47 ,302.27 ,171233,172765
20150414,412,414,405,407,322806,132216904,287208,-5,-1.21 ,222.22 ,160263,162543
20150413,410,413,406,412,342724,140427120,289488,2,0.49 ,172.41 ,171908,170816
20150410,409,412,405,411,351856,143849888,288396,2,0.49 ,172.84 ,175536,176320
20150409,419,419,407,409,327698,135166352,289180,-10,-2.39 ,294.84 ,163226,164472
20150408,412,419,411,419,391666,162869152,290426,7,1.70 ,194.65 ,196859,194807
20150407,417,419,411,412,388808,161440672,288374,-5,-1.20 ,194.65 ,193301,195507
20150403,416,417,410,417,326150,135049888,290580,1,0.24 ,170.73 ,162634,163516
20150402,407,416,406,416,331180,136359728,291462,9,2.21 ,246.31 ,166062,165118
20150401,415,416,406,407,377754,155084352,290518,-8,-1.93 ,246.31 ,188199,189555
20150331,414,415,409,415,283026,116688272,291874,1,0.24 ,146.70 ,141442,141584
20150330,418,419,411,412,297204,123489960,292016,-6,-1.44 ,194.65 ,148243,148961
20150327,416,419,411,418,223806,92849336,292734,2,0.48 ,194.65 ,111445,112361
20150326,421,423,415,416,239038,100146840,293650,-5,-1.19 ,192.77 ,119783,119255
20150325,418,422,415,421,229352,96058632,293122,3,0.72 ,168.67 ,115031,114321
20150324,415,418,411,418,322402,133607032,292412,3,0.72 ,170.32 ,161571,160831
20150323,414,417,410,415,247588,102445504,291672,1,0.24 ,170.73 ,123948,123640
20150320,417,418,412,414,271952,112874792,291364,-3,-0.72 ,145.63 ,134965,136987
20150319,414,417,410,417,281860,116565696,293386,3,0.72 ,170.73 ,141336,140524
20150318,417,418,411,414,209096,86756848,292574,-3,-0.72 ,170.32 ,104276,104820
20150317,415,417,411,417,242776,100540768,293118,2,0.48 ,145.99 ,121769,121007
20150316,412,415,407,415,242120,99572056,292356,3,0.73 ,196.56 ,121421,120699
20150313,413,416,409,412,284322,117231352,291634,-1,-0.24 ,171.15 ,141690,142632
20150312,409,413,406,413,268904,110057976,292576,4,0.98 ,172.41 ,134760,134144
20150311,409,411,406,409,171398,70072496,291960,0,0.00 ,123.15 ,85923,85475
20150310,407,409,402,409,241426,97939688,291512,2,0.49 ,174.13 ,121354,120072
20150309,402,407,400,407,292552,117910064,290230,5,1.24 ,175.00 ,146687,145865
20150306,403,407,401,402,327992,132469584,289408,-1,-0.25 ,149.63 ,163075,164917
20150305,398,403,395,403,375240,149819104,291250,5,1.26 ,202.53 ,188288,186952
20150304,397,398,390,398,431312,170194640,289914,1,0.25 ,205.13 ,216018,215294
20150303,394,397,391,397,458642,180836592,289190,3,0.76 ,153.45 ,229564,229078
20150302,396,398,391,394,349876,137946288,288704,-2,-0.51 ,179.03 ,174601,175275
20150228,387,396,385,396,581282,227708912,289378,9,2.33 ,285.71 ,291075,290207
20150227,375,387,373,387,653432,249750128,288510,12,3.20 ,375.34 ,327605,325827
20150226,369,375,365,375,660714,245324576,286732,6,1.63 ,273.97 ,330733,329981
20150225,373,378,366,369,518636,192814208,285980,-4,-1.07 ,327.87 ,260013,258623
20150217,370,376,368,373,573394,213371664,284590,3,0.81 ,217.39 ,286254,287140
20150216,373,376,367,370,593898,220470016,285476,-3,-0.80 ,245.23 ,296744,297154
20150215,369,376,366,373,547016,203174320,285886,4,1.08 ,273.22 ,274058,272958
20150213,366,371,361,369,621862,227600784,284786,3,0.82 ,277.01 ,309061,312801
20150212,353,364,350,364,621676,222424448,288526,11,3.12 ,400.00 ,310169,311507
20150211,356,358,350,353,549634,194414592,289864,-3,-0.84 ,228.57 ,275190,274444
20150210,352,359,345,356,638874,224881776,289118,4,1.14 ,405.80 ,319873,319001
20150209,351,356,347,352,643088,226011136,288246,1,0.28 ,259.37 ,321667,321421
20150206,353,359,347,351,592250,209653744,288000,-2,-0.57 ,345.82 ,294475,297775
20150205,359,361,350,353,582348,206718560,291300,-6,-1.67 ,314.29 ,291092,291256
20150204,358,359,351,359,623822,221823216,291464,1,0.28 ,227.92 ,311091,312731
20150203,369,370,355,358,628476,226820576,293104,-11,-2.98 ,422.54 ,315142,313334
20150202,376,378,367,369,694940,258525632,291296,-7,-1.86 ,299.73 ,347771,347169
20150130,375,382,370,376,679462,255474368,290694,1,0.27 ,324.32 ,339705,339757
20150129,368,375,364,375,582522,215634768,290746,7,1.90 ,302.20 ,290944,291578
20150128,378,381,367,368,563860,209299856,291380,-10,-2.65 ,381.47 ,280664,283196
20150127,369,378,367,375,564456,210950832,293912,6,1.63 ,299.73 ,282628,281828
20150126,366,369,361,369,614412,224186608,293112,3,0.82 ,221.61 ,307593,306819
20150123,365,368,361,366,627568,228928560,292338,1,0.27 ,193.91 ,313321,314247
20150122,361,365,355,365,655626,235866848,293264,4,1.11 ,281.69 ,326164,329462
20150121,370,386,361,361,539080,197070320,296562,-9,-2.43 ,692.52 ,269796,269284
20150120,376,377,367,369,586826,217924704,296050,-7,-1.86 ,272.48 ,293597,293229
20150119,380,383,372,376,631882,238746832,295682,-4,-1.05 ,295.70 ,316044,315838
20150116,379,382,374,381,635314,240711200,295476,2,0.53 ,213.90 ,318020,317294
20150115,378,382,374,379,617944,233625120,294750,1,0.26 ,213.90 ,309732,308212
20150114,374,378,370,378,685418,256559568,293230,4,1.07 ,216.22 ,341861,343557
20150113,379,380,370,374,702334,263664944,294926,-5,-1.32 ,270.27 ,351535,350799
20150112,388,388,376,379,595942,227181632,294190,-9,-2.32 ,319.15 ,298344,297598
20150109,391,396,385,388,657872,256525536,293444,-3,-0.77 ,285.71 ,328707,329165
20150108,391,394,387,393,723404,282308864,293902,2,0.51 ,180.88 ,360407,362997
20150107,389,396,386,391,902956,352750144,296492,2,0.51 ,259.07 ,451927,451029
20150106,397,397,385,389,770404,300270496,295594,-8,-2.02 ,311.69 ,385257,385147
20150105,391,393,386,393,774588,301562560,295484,2,0.51 ,181.35 ,386653,387935
20150104,398,400,389,391,551612,217335504,296766,-7,-1.76 ,282.78 ,275922,275690
20141231,397,399,392,398,374760,148303728,296534,1,0.25 ,178.57 ,187158,187602
20141230,401,404,396,397,1006066,401794496,296978,-4,-1.00 ,202.02 ,503998,502068
20141229,404,405,397,401,958286,384134368,295048,-3,-0.74 ,201.51 ,479510,478776
20141226,402,405,397,404,878520,352515712,294314,2,0.50 ,201.51 ,439415,439105
20141225,406,408,400,402,1021574,412506112,294004,-4,-0.99 ,200.00 ,510505,511069
20141224,403,408,400,406,987100,398705856,294568,3,0.74 ,200.00 ,493630,493470
20141223,394,405,393,403,985606,395220608,294408,9,2.28 ,305.34 ,492300,493306
20141222,383,394,382,394,876476,340332032,295414,11,2.87 ,314.14 ,436348,440128
20141219,384,388,381,383,956992,367800800,299194,-1,-0.26 ,183.73 ,478650,478342
20141218,389,390,383,383,1484198,572994752,298886,-6,-1.54 ,182.77 ,743031,741167
20141217,383,391,381,389,950202,367369856,297022,6,1.57 ,262.47 ,472378,477824
20141216,378,387,378,383,736864,281969376,302468,5,1.32 ,238.10 ,368201,368663
20141215,375,385,374,378,768890,291918240,302930,3,0.80 ,294.12 ,384130,384760
20141212,373,379,371,375,835744,313573056,303560,2,0.54 ,215.63 ,417410,418334
20141211,368,375,364,373,752238,278238560,304484,5,1.36 ,302.20 ,373473,378765
20141210,373,376,368,368,678534,252417120,309776,-5,-1.34 ,217.39 ,339700,338834
20141209,376,380,373,373,536966,202083472,308910,-3,-0.80 ,187.67 ,268875,268091
20141208,373,379,370,376,656872,246429648,308126,3,0.80 ,243.24 ,328897,327975
20141205,374,380,371,373,771960,289842784,307204,-1,-0.27 ,242.59 ,387179,384781
20141204,376,382,373,374,785852,296303616,304806,-2,-0.53 ,241.29 ,393354,392498
20141203,377,387,376,377,642454,244684352,303950,0,0.00 ,292.55 ,321675,320779
20141202,372,379,369,377,1783906,667458432,303054,5,1.34 ,271.00 ,891478,892428
20141201,373,378,370,372,734340,274739424,304004,-1,-0.27 ,216.22 ,367343,366997
20141128,364,379,364,373,664722,247904144,303658,9,2.47 ,412.09 ,331920,332802
20141127,350,367,350,364,632082,227959744,304540,14,4.00 ,485.71 ,317174,314908
20141126,338,352,337,350,666992,229092160,302274,12,3.55 ,445.10 ,332795,334197
20141125,341,347,337,338,741296,253773952,303676,-3,-0.88 ,296.74 ,372355,368941
20141124,350,354,341,341,669612,231696640,300262,-9,-2.57 ,381.23 ,336001,333611
20141121,340,352,340,350,569984,197836496,297872,10,2.94 ,352.94 ,284145,285839
20141120,343,347,336,340,668122,228804416,299566,-3,-0.87 ,327.38 ,334070,334052
20141119,341,347,336,343,709504,242603696,299548,2,0.59 ,327.38 ,352004,357500
20141118,348,352,341,341,684514,237402592,305044,-7,-2.01 ,322.58 ,342153,342361
20141117,350,355,346,348,678768,238021376,305252,-2,-0.57 ,260.12 ,338285,340483
20141114,363,364,349,350,613482,217645280,307450,-13,-3.58 ,429.80 ,306359,307123
20141113,368,373,363,363,679074,250039824,308214,-5,-1.36 ,275.48 ,338841,340233
20141112,356,370,356,368,655174,238479040,309606,12,3.37 ,393.26 ,325612,329562
20141111,355,361,354,356,696870,249221872,313556,1,0.28 ,197.74 ,347378,349492
20141110,349,357,345,355,686888,240914176,315670,6,1.72 ,347.83 ,339196,347692
20141107,357,358,347,349,663276,233451040,324166,-8,-2.24 ,317.00 ,331315,331961
20141106,355,362,351,357,616124,219435088,324812,2,0.56 ,313.39 ,308328,307796
20141105,349,356,343,355,610776,213561968,324280,6,1.72 ,379.01 ,304034,306742
20141104,343,354,341,349,611568,212990640,326988,6,1.75 ,381.23 ,302567,309001
20141103,349,352,340,343,595266,206098160,333422,-6,-1.72 ,352.94 ,296090,299176
20141031,350,354,347,349,563956,197614112,336508,-1,-0.29 ,201.73 ,278254,285702
20141030,354,358,349,350,490820,173322576,343956,-4,-1.13 ,257.88 ,245803,245017
20141029,348,358,346,354,632470,221991200,343170,6,1.72 ,346.82 ,315116,317354
20141028,350,357,348,348,612102,216017120,345408,-2,-0.57 ,258.62 ,306046,306056
20141027,338,352,336,350,540120,186185232,345418,12,3.55 ,476.19 ,266766,273354
20141024,335,342,334,338,639930,216127696,352006,3,0.90 ,239.52 ,318729,321201
20141023,337,339,329,335,499326,166842576,354478,-2,-0.59 ,303.95 ,247621,251705
20141022,341,348,337,337,503204,172352016,358562,-4,-1.17 ,326.41 ,250805,252399
20141021,350,353,340,341,423576,146735776,360156,-9,-2.57 ,382.35 ,210835,212741
20141020,355,357,347,350,566426,199222912,362062,-5,-1.41 ,288.18 ,282926,283500
20141017,352,359,350,355,694676,246483328,362636,3,0.85 ,257.14 ,344420,350256
20141016,343,355,342,352,567730,197248144,368472,9,2.62 ,380.12 ,281584,286146
20141015,337,346,335,343,921920,313383168,373034,6,1.78 ,328.36 ,458289,463631
20141014,347,348,334,337,808296,275248800,378376,-10,-2.88 ,419.16 ,403503,404793
20141013,351,358,345,347,984982,345188928,379666,-4,-1.14 ,376.81 ,491557,493425
20141011,349,356,347,351,750544,263516128,381534,2,0.57 ,259.37 ,374978,375566
20141010,351,353,346,349,810674,282885888,382122,-2,-0.57 ,202.31 ,402605,408069
20141009,354,356,347,351,704490,247256064,387586,-3,-0.85 ,259.37 ,351638,352852
20141008,351,360,350,354,1160818,411722944,388800,3,0.85 ,285.71 ,582071,578747
20140930,358,359,351,351,984060,348531168,385476,-7,-1.96 ,227.92 ,487887,496173
20140929,359,363,356,358,1358282,488537344,393762,-1,-0.28 ,196.63 ,677371,680911
20140928,357,362,355,359,1821074,653750976,397302,2,0.56 ,197.18 ,909412,911662
20140926,360,361,349,357,1433102,506630624,399552,-3,-0.83 ,343.84 ,715814,717288
20140925,366,369,360,360,1384330,503142208,401026,-6,-1.64 ,250.00 ,695448,688882
20140924,377,378,366,366,1484128,551982784,394460,-11,-2.92 ,327.87 ,745169,738959
20140923,375,385,374,377,1636266,621398272,388250,2,0.53 ,294.12 ,819177,817089
20140922,373,379,366,375,1728284,642373888,386162,2,0.54 ,355.19 ,862915,865369
20140919,372,380,371,373,2126528,799503168,388616,1,0.27 ,242.59 ,1062677,1063851
20140918,373,377,368,372,2224072,830424256,389790,-1,-0.27 ,244.57 ,1112617,1111455
20140917,380,384,373,373,2684020,1019038144,388628,-7,-1.84 ,294.91 ,1345579,1338441
20140916,381,386,376,380,3001444,1142375808,381490,-1,-0.26 ,265.96 ,1502182,1499262
20140915,384,388,379,381,3276602,1254546816,378570,-3,-0.78 ,237.47 ,1641267,1635335
20140912,381,388,380,384,3213848,1234540800,372638,3,0.79 ,210.53 ,1606250,1607598
20140911,378,387,377,381,3022504,1157955840,373986,3,0.79 ,265.25 ,1511782,1510722
20140910,384,390,374,378,2677872,1021862144,372926,-6,-1.56 ,427.81 ,1339965,1337907
20140909,389,393,385,385,1827766,711093696,370868,-4,-1.03 ,207.79 ,914751,913015
20140905,394,395,383,389,2874420,1115017088,369132,-5,-1.27 ,313.32 ,1435583,1438837
20140904,409,410,394,394,2962732,1186902272,372386,-15,-3.67 ,406.09 ,1482101,1480631
20140903,417,419,407,409,2665704,1097051648,370916,-8,-1.92 ,294.84 ,1333390,1332314
20140902,428,434,418,418,2564036,1092951680,369840,-10,-2.34 ,382.78 ,1285084,1278952
20140901,436,438,427,428,2598508,1123142016,363708,-8,-1.83 ,257.61 ,1303045,1295463
20140829,433,438,426,436,2909638,1257377408,356126,3,0.69 ,281.69 ,1452589,1457049
20140828,432,441,428,433,2730070,1184975744,360586,1,0.23 ,303.74 ,1364604,1365466
20140827,443,445,431,433,2625476,1149238784,361448,-10,-2.26 ,324.83 ,1312589,1312887
20140826,428,443,424,443,2554538,1115135104,361746,15,3.50 ,448.11 ,1276783,1277755
20140825,423,428,418,428,2456144,1037820032,362718,5,1.18 ,239.23 ,1226712,1229432
20140822,429,432,417,423,2714816,1156202240,365438,-6,-1.40 ,359.71 ,1357057,1357759
20140821,416,432,415,429,3016190,1275441920,366140,13,3.13 ,409.64 ,1506359,1509831
20140820,405,418,399,416,2670126,1093933568,369612,11,2.72 ,476.19 ,1331308,1338818
20140819,422,424,405,405,2720434,1124468736,377122,-17,-4.03 ,469.14 ,1360081,1360353
20140818,425,428,414,422,2595278,1092684288,377394,-3,-0.71 ,338.16 ,1297468,1297810
20140815,427,433,420,425,2706170,1156079232,377736,-2,-0.47 ,309.52 ,1352054,1354116
20140814,419,435,418,427,2602046,1113090048,379798,8,1.91 ,406.70 ,1294764,1307282
20140813,404,419,401,419,2298728,944200448,392316,15,3.71 ,448.88 ,1143091,1155637
20140812,401,413,398,404,2647936,1072796736,404862,3,0.75 ,376.88 ,1316871,1331065
20140811,400,403,389,401,2640174,1048397056,419056,1,0.25 ,359.90 ,1314699,1325475
20140808,406,415,397,400,3002624,1212252928,429832,-6,-1.48 ,453.40 ,1476788,1525836
20140807,393,406,387,406,3540570,1408583424,478880,13,3.31 ,490.96 ,1770397,1770173
20140806,407,410,392,393,3860874,1544191104,478656,-14,-3.44 ,459.18 ,1930849,1930025
20140805,405,415,401,407,3476006,1418589568,477832,2,0.49 ,349.13 ,1738139,1737867
20140804,406,412,395,405,3292136,1330183680,477560,-1,-0.25 ,430.38 ,1646782,1645354
20140801,415,417,402,406,3515574,1439488000,476132,-9,-2.17 ,373.13 ,1755447,1760127
20140731,417,423,410,415,2992496,1246196352,480812,-2,-0.48 ,317.07 ,1498429,1494067
20140730,421,426,411,417,2811812,1178068480,476450,-4,-0.95 ,364.96 ,1406457,1405355
20140729,434,437,417,421,2803154,1193207296,475348,-13,-3.00 ,479.62 ,1397821,1405333
20140728,444,445,434,434,2891494,1270719104,482860,-10,-2.25 ,253.46 ,1446584,1444910
20140725,443,445,435,444,2771200,1219783808,481186,1,0.23 ,229.89 ,1383762,1387438
20140724,440,447,438,443,3041704,1345930624,484862,3,0.68 ,205.48 ,1521478,1520226
20140723,439,443,432,440,2951520,1287623424,483610,1,0.23 ,254.63 ,1474555,1476965
20140722,447,448,438,439,2984684,1318887296,486020,-8,-1.79 ,228.31 ,1492774,1491910
20140721,455,458,445,447,3012154,1358171264,485156,-8,-1.76 ,292.13 ,1507147,1505007
20140718,456,460,451,455,3102886,1411918720,483016,-1,-0.22 ,199.56 ,1550795,1552091
20140717,465,469,456,456,2969548,1371323136,484312,-9,-1.94 ,285.09 ,1484765,1484783
20140716,459,466,457,465,3065440,1414790144,484330,6,1.31 ,196.94 ,1534391,1531049
20140715,461,465,458,459,3028084,1397048064,480988,-2,-0.43 ,152.84 ,1514850,1513234
20140714,458,462,453,461,3047960,1396599424,479372,3,0.66 ,198.68 ,1525693,1522267
20140711,453,462,447,458,2999958,1361033728,475946,5,1.10 ,335.57 ,1498846,1501112
20140710,462,464,451,453,3385534,1547988992,478212,-9,-1.95 ,288.25 ,1693114,1692420
20140709,463,466,458,462,3217704,1486391168,477518,-1,-0.22 ,174.67 ,1608626,1609078
20140708,466,474,462,463,3453872,1614134144,477970,-3,-0.64 ,259.74 ,1728873,1724999
20140707,461,468,461,466,3568468,1656440320,474096,5,1.08 ,151.84 ,1784434,1784034
20140704,463,464,457,461,3730854,1717369600,473696,-2,-0.43 ,153.17 ,1863634,1867220
20140703,463,466,458,463,3526522,1630772224,477282,0,0.00 ,174.67 ,1764777,1761745
20140702,465,469,462,463,3527762,1642941824,474250,-2,-0.43 ,151.52 ,1763783,1763979
20140701,459,465,457,465,3204820,1478372736,474446,6,1.31 ,175.05 ,1602902,1601918
20140630,467,469,459,459,2839048,1320533376,473462,-8,-1.71 ,217.86 ,1417590,1421458
20140627,466,469,460,467,3018602,1403275008,477330,1,0.21 ,195.65 ,1509737,1508865
20140626,463,469,462,466,3065870,1425262464,476458,3,0.65 ,151.52 ,1533379,1532491
20140625,464,467,461,463,3240744,1503362048,475570,-1,-0.22 ,130.15 ,1619524,1621220
20140624,478,480,463,464,2807950,1318411904,477266,-14,-2.93 ,367.17 ,1402158,1405792
20140623,476,478,469,478,2788240,1320204928,480900,2,0.42 ,191.90 ,1394821,1393419
20140620,481,483,472,476,3211272,1534363136,479498,-5,-1.04 ,233.05 ,1604334,1606938
20140619,478,485,476,481,2514172,1206301568,482102,3,0.63 ,189.08 ,1257424,1256748
20140618,482,484,475,478,3378182,1619384320,481426,-4,-0.83 ,189.47 ,1686160,1692022
20140617,485,494,481,482,4236402,2069611904,487288,-3,-0.62 ,270.27 ,2117246,2119156
20140616,486,490,484,485,1727762,840444992,489198,-1,-0.21 ,123.97 ,863153,864609
20140613,480,493,479,486,4407858,2145615104,490654,6,1.25 ,292.28 ,2202283,2205575
20140612,476,488,474,480,4360286,2103417088,493946,4,0.84 ,295.36 ,2181352,2178934
20140611,463,476,461,476,4285762,2013748992,491528,13,2.81 ,325.38 ,2144678,2141084
20140610,462,468,460,463,4000670,1857275264,487934,1,0.22 ,173.91 ,2000525,2000145
20140609,452,462,450,462,4117242,1886503040,487554,10,2.21 ,266.67 ,2060072,2057170
20140606,448,453,445,452,3537514,1588140800,484652,4,0.89 ,179.78 ,1769418,1768096
20140605,438,448,438,447,3502758,1553901312,483330,9,2.05 ,228.31 ,1752453,1750305
20140604,439,442,436,438,2966456,1303581056,481182,-1,-0.23 ,137.61 ,1484083,1482373
20140603,440,442,435,438,2529748,1109334528,479472,-2,-0.45 ,160.92 ,1265311,1264437
20140530,450,452,440,441,3579144,1595720704,478598,-9,-2.00 ,272.73 ,1786664,1792480
20140529,443,450,439,450,3276768,1455896576,484414,7,1.58 ,250.57 ,1639135,1637633
20140528,447,452,439,443,2983214,1325545728,482912,-4,-0.89 ,296.13 ,1491624,1491590
20140527,437,448,435,447,3128874,1385174016,482878,10,2.29 ,298.85 ,1564822,1564052
20140526,429,438,428,437,2854376,1235964416,482108,8,1.86 ,233.64 ,1427264,1427112
20140523,439,441,428,430,2878278,1249469824,481956,-9,-2.05 ,303.74 ,1438387,1439891
20140522,443,447,438,440,3038596,1344208768,483460,-3,-0.68 ,205.48 ,1518463,1520133
20140521,434,444,433,443,2983042,1312822272,485130,9,2.07 ,254.04 ,1491914,1491128
20140520,435,438,428,434,3306926,1433392512,484344,-1,-0.23 ,233.64 ,1652742,1654184
20140519,441,443,431,435,3564552,1555835776,485786,-6,-1.36 ,278.42 ,1782669,1781883
20140516,441,456,439,442,4167218,1862838016,485000,1,0.23 ,387.24 ,2082942,2084276
20140515,438,446,435,442,1670834,735796032,486334,4,0.91 ,252.87 ,835465,835369
20140514,424,438,423,438,3903360,1684886144,486238,14,3.30 ,354.61 ,1949949,1953411
20140513,429,436,424,424,4011424,1722825728,489700,-5,-1.17 ,283.02 ,2004328,2007096
20140512,418,430,415,428,3700326,1562047616,492468,10,2.39 ,361.45 ,1850395,1849931
20140509,428,431,415,418,4080852,1732087552,492004,-10,-2.34 ,385.54 ,2039694,2041158
20140508,430,441,426,429,3614122,1566308352,493468,-1,-0.23 ,352.11 ,1808601,1805521
20140507,436,442,427,430,3364770,1461603712,490388,-6,-1.38 ,351.29 ,1683374,1681396
20140506,441,445,435,438,4195564,1845197184,488410,-3,-0.68 ,229.89 ,2097794,2097770
20140505,448,457,438,441,4458592,1992440192,488386,-7,-1.56 ,433.79 ,2228736,2229856
20140430,448,452,440,448,3592334,1602169856,489506,0,0.00 ,272.73 ,1795416,1796918
20140429,433,448,432,448,3716542,1643301376,491008,15,3.46 ,370.37 ,1861475,1855067
20140428,437,442,430,434,3947624,1718339456,484600,-3,-0.69 ,279.07 ,1973715,1973909
20140425,418,437,415,437,4275476,1825343872,484794,19,4.55 ,530.12 ,2137331,2138145
20140424,409,420,405,416,3030054,1248124672,485608,7,1.71 ,370.37 ,1515445,1514609
20140423,424,426,408,409,2468580,1033286144,484772,-15,-3.54 ,441.18 ,1233508,1235072
20140422,422,424,414,424,2958854,1239613184,486336,2,0.47 ,241.55 ,1480270,1478584
20140421,418,424,411,422,2754162,1151272448,484650,4,0.96 ,316.30 ,1378995,1375167
20140418,415,418,407,417,2729168,1127000960,480822,2,0.48 ,270.27 ,1367573,1361595
20140417,419,424,413,415,2442148,1021300160,474844,-4,-0.95 ,266.34 ,1219822,1222326
20140416,412,422,410,419,2584798,1074878976,477348,7,1.70 ,292.68 ,1294804,1289994
20140415,414,417,407,412,2556064,1052881600,472538,-2,-0.48 ,245.70 ,1283802,1272262
20140411,400,403,396,401,1302434,521223296,460998,1,0.25 ,176.77 ,647796,654638
20140410,405,408,398,400,2252516,909189184,467840,-5,-1.23 ,251.26 ,1129406,1123110
20140409,405,411,402,405,2256544,916446144,461544,0,0.00 ,223.88 ,1128718,1127826
20140408,401,408,398,405,2428598,981338432,460652,4,1.00 ,251.26 ,1214904,1213694
20140404,399,404,396,401,2514996,1006226752,459442,2,0.50 ,202.02 ,1258934,1256062
20140403,396,404,394,399,2499570,997295360,456570,3,0.76 ,253.81 ,1251309,1248261
20140402,406,410,395,396,2256466,908985728,453522,-10,-2.46 ,379.75 ,1131573,1124893
20140401,414,418,405,406,1981570,814791424,446842,-8,-1.93 ,320.99 ,993471,988099
20140331,403,415,401,414,2099906,852999808,441470,11,2.73 ,349.13 ,1050762,1049144
20140328,397,405,393,403,1945172,777112704,439852,6,1.51 ,305.34 ,970924,974248
20140327,401,403,392,397,1991520,790409664,443176,-4,-1.00 ,280.61 ,994832,996688
20140326,399,404,394,401,1709302,682640384,445032,2,0.50 ,253.81 ,855059,854243
20140325,395,406,393,399,1936686,776524480,444216,4,1.01 ,330.79 ,968264,968422
20140324,396,401,392,395,2026816,801844160,444374,-1,-0.25 ,229.59 ,1014374,1012442
20140321,401,404,393,396,1737384,690909376,442442,-5,-1.25 ,279.90 ,867335,870049
20140320,392,401,391,401,1712424,676979968,445156,9,2.30 ,255.75 ,856197,856227
20140319,377,393,377,392,1720620,662301568,445186,15,3.98 ,424.40 ,857765,862855
20140318,372,381,372,377,1848610,696066816,450276,5,1.34 ,241.94 ,925237,923373
20140317,369,376,368,372,2125012,791216704,448412,3,0.81 ,217.39 ,1064951,1060061
20140314,370,377,368,369,3203294,1193074176,443522,-1,-0.27 ,244.57 ,1599341,1603953
20140313,369,378,369,370,2497712,932529088,448134,1,0.27 ,243.90 ,1248073,1249639
20140312,366,372,363,369,1884052,693950528,449700,3,0.82 ,247.93 ,943406,940646
20140311,368,373,363,366,1755630,646034816,446940,-2,-0.54 ,275.48 ,877463,878167
20140310,367,372,365,368,1618404,596230336,447644,1,0.27 ,191.78 ,811713,806691
20140307,367,373,365,367,1627788,600296640,442622,0,0.00 ,219.18 ,810446,817342
20140306,363,370,360,367,1697866,620727808,449518,4,1.10 ,277.78 ,847645,850221
20140305,365,367,360,363,2324540,845567680,452094,-2,-0.55 ,194.44 ,1163489,1161051
20140304,366,369,361,365,2340426,854821248,449656,-1,-0.27 ,221.61 ,1171700,1168726
20140303,367,370,361,366,2109256,771548992,446682,-1,-0.27 ,249.31 ,1055849,1053407
20140228,362,370,359,367,1942664,710194368,444240,5,1.38 ,306.41 ,971177,971487
20140227,359,363,355,362,2326764,835057984,444550,3,0.84 ,225.35 ,1162427,1164337
20140226,355,361,351,359,2432530,866780800,446460,4,1.13 ,284.90 ,1215040,1217490
20140225,356,360,350,355,2150338,764788992,448910,-1,-0.28 ,285.71 ,1077017,1073321
20140224,364,364,356,356,2543906,915077440,445214,-8,-2.20 ,224.72 ,1274143,1269763
20140221,355,364,352,364,2822286,1009138432,440834,9,2.54 ,340.91 ,1413057,1409229
20140220,351,361,351,355,2368472,841268544,437006,4,1.14 ,284.90 ,1186226,1182246
20140219,342,354,339,351,2441964,847340672,433026,9,2.63 ,442.48 ,1219383,1222581
20140218,343,350,337,342,2851540,980702464,436224,-1,-0.29 ,385.76 ,1428616,1422924
20140217,346,352,340,343,2753508,951123648,430532,-3,-0.87 ,352.94 ,1379070,1374438
20140214,336,347,334,346,2822264,963208896,425900,10,2.98 ,389.22 ,1410472,1411792
20140213,332,342,330,336,2607666,875860928,427220,4,1.20 ,363.64 ,1306619,1301047
20140212,322,334,322,332,2556126,838417920,421648,10,3.11 ,372.67 ,1276332,1279794
20140211,308,326,307,322,2356786,744006784,425110,14,4.55 ,618.89 ,1169199,1187587
20140210,313,315,303,307,2169210,670471104,443498,-6,-1.92 ,396.04 ,1089696,1079514
20140207,302,319,302,313,2790500,869477184,433316,11,3.64 ,562.91 ,1397496,1393004
20140129,294,304,289,302,2425158,716066112,428824,8,2.72 ,519.03 ,1207426,1217732
20140128,290,298,287,294,2788680,815512448,439130,4,1.38 ,383.28 ,1393476,1395204
20140127,298,301,290,290,2763814,817964160,440858,-8,-2.68 ,379.31 ,1385113,1378701
20140124,293,300,292,298,2997978,890263104,434446,5,1.71 ,273.97 ,1495279,1502699
20140123,295,299,288,293,2279338,668243712,441866,-2,-0.68 ,381.94 ,1141616,1137722
20140122,298,301,292,295,2528172,751034816,437972,-3,-1.01 ,308.22 ,1265760,1262412
20140121,301,303,296,298,2661022,797167936,434624,-3,-1.00 ,236.49 ,1329288,1331734
20140120,301,303,300,301,82152,24734694,437070,0,0.00 ,100.00 ,43907,38245
20140117,292,301,288,301,3048246,896712704,431408,9,3.08 ,451.39 ,1521003,1527243
20140116,293,298,291,292,2812454,827907264,437648,-1,-0.34 ,240.55 ,1407468,1404986
20140115,297,302,292,293,2748384,817430528,435166,-4,-1.35 ,342.47 ,1376266,1372118
20140114,290,300,288,297,2972644,871814848,431018,7,2.41 ,416.67 ,1487206,1485438
20140113,290,295,288,289,2994648,873035584,429250,-1,-0.34 ,243.06 ,1500514,1494134
20140110,286,292,282,290,2916230,835819712,422870,4,1.40 ,354.61 ,1455549,1460681
20140109,279,287,277,286,2787504,787500416,428002,7,2.51 ,361.01 ,1394764,1392740
20140108,272,281,271,279,2876588,797413888,425978,7,2.57 ,369.00 ,1440153,1436435
20140107,269,276,267,271,2714864,737172096,422260,2,0.74 ,337.08 ,1360416,1354448
20140106,264,271,263,269,3263254,869640512,416292,5,1.89 ,304.18 ,1631818,1631436
20140103,250,266,250,264,2618056,674471552,415910,14,5.60 ,640.00 ,1306838,1311218
20140102,244,253,243,249,2561794,640709696,420290,5,2.05 ,411.52 ,1279728,1282066
20131231,233,246,233,244,1889486,449502080,422628,11,4.72 ,557.94 ,941933,947553
20131230,236,240,233,233,2570780,606270464,428248,-3,-1.27 ,300.43 ,1288084,1282696
20131227,238,239,232,236,2736400,644931648,422860,-2,-0.84 ,301.72 ,1368832,1367568
20131226,246,248,238,238,2808784,682967744,421596,-8,-3.25 ,420.17 ,1407397,1401387
20131225,253,255,244,246,2529118,627437056,415586,-7,-2.77 ,450.82 ,1267771,1261347
20131224,258,262,253,253,2836046,731049920,409162,-5,-1.94 ,355.73 ,1424085,1411961
20131223,247,261,246,258,1933838,490793792,397038,11,4.45 ,609.76 ,965765,968073
20131220,245,252,243,247,2268048,562689664,399346,2,0.82 ,370.37 ,1136457,1131591
20131219,257,260,250,253,929284,236780896,394480,-4,-1.56 ,400.00 ,464855,464429
20131218,253,260,248,257,1870814,475997184,394054,4,1.58 ,483.87 ,934146,936668
20131217,251,258,248,253,1940642,493772416,396576,2,0.80 ,403.23 ,967577,973065
20131216,269,272,251,251,2221110,585680512,402064,-18,-6.69 ,836.65 ,1109305,1111805
20131213,274,279,268,269,2150068,588972352,404564,-5,-1.82 ,410.45 ,1076437,1073631
20131212,265,277,264,274,2032560,549366656,401758,9,3.40 ,492.42 ,1014142,1018418
20131211,268,269,263,265,1845874,490836192,406034,-3,-1.12 ,228.14 ,924098,921776
20131210,268,273,266,268,2106302,567656768,403712,0,0.00 ,263.16 ,1052998,1053304
20131209,264,271,264,268,1666754,446022912,404018,4,1.52 ,265.15 ,833229,833525
20131206,265,271,261,264,2314820,615872576,404314,-1,-0.38 ,383.14 ,1152761,1162059
20131205,266,270,262,265,2200870,586379968,413612,-1,-0.38 ,305.34 ,1101685,1099185
20131204,275,280,266,266,2433016,661298624,411112,-9,-3.27 ,526.32 ,1217259,1215757
20131203,270,276,268,275,1779222,483003744,409610,5,1.85 ,298.51 ,888075,891147
20131202,264,274,263,270,1635072,439689472,412682,6,2.27 ,418.25 ,813338,821734
20131129,260,266,256,264,2001308,521670496,421078,4,1.54 ,390.63 ,992984,1008324
20131128,261,268,259,260,1829386,481494624,436418,-1,-0.38 ,347.49 ,915333,914053
20131127,253,263,248,261,2058952,524084192,435138,8,3.16 ,604.84 ,1025382,1033570
20131126,254,256,247,253,2285974,574169344,443326,-1,-0.39 ,364.37 ,1147616,1138358
20131125,264,266,248,254,2523290,648497216,434068,-10,-3.79 ,725.81 ,1264435,1258855
20131122,278,281,262,264,3052826,821150016,428488,-14,-5.04 ,725.19 ,1535789,1517037
20131121,276,281,269,278,2611420,713315584,409736,2,0.72 ,446.10 ,1298364,1313056
20131120,288,292,276,276,2534006,719145536,424428,-12,-4.17 ,579.71 ,1270284,1263722
20131119,293,299,288,288,2204352,648416064,417866,-5,-1.71 ,381.94 ,1106763,1097589
20131118,291,296,286,296,1858152,538813120,408692,5,1.72 ,349.65 ,930142,928010
20131115,299,301,291,291,2864628,851043584,406560,-8,-2.68 ,343.64 ,1456185,1408443
20131114,302,305,297,299,2713316,816864320,358818,-3,-0.99 ,269.36 ,1368536,1344780
20131113,310,312,302,302,3228566,989527232,335062,-8,-2.58 ,331.13 ,1638212,1590354
20131112,300,310,299,310,2658478,809475392,287204,10,3.33 ,367.89 ,1324617,1333861
20131111,294,303,293,300,2241280,667233216,296448,6,2.04 ,341.30 ,1127535,1113745
20131108,299,305,298,298,1364512,411008800,282658,-1,-0.33 ,234.90 ,693589,670923
20131107,294,302,293,299,2284158,678449216,259992,5,1.70 ,307.17 ,1139731,1144427
20131106,300,302,293,294,2260348,674633600,264688,-6,-2.00 ,307.17 ,1135336,1125012
20131105,298,303,296,300,2220920,664510272,254364,2,0.67 ,236.49 ,1109199,1111721
20131104,297,300,294,298,2009566,596698368,256886,1,0.34 ,204.08 ,1002115,1007451
20131101,298,304,295,297,2017652,605225664,262222,-1,-0.34 ,305.08 ,1006431,1011221
20131031,300,302,293,298,2565434,762909824,267012,-2,-0.67 ,307.17 ,1280769,1284665
20131030,303,308,296,300,2796250,848209408,270908,-3,-0.99 ,405.41 ,1397981,1398269
20131029,304,308,300,303,2979570,906284416,271196,-1,-0.33 ,266.67 ,1486907,1492663
20131028,305,310,302,304,3371168,1032101376,276952,-1,-0.33 ,264.90 ,1688211,1682957
20131025,307,310,303,305,3030704,929636608,271698,-2,-0.65 ,231.02 ,1513277,1517427
20131024,296,307,294,307,2654148,795830080,275848,11,3.72 ,442.18 ,1337646,1316502
20131023,283,297,282,296,2992578,867398208,254704,13,4.59 ,531.91 ,1496010,1496568
20131022,271,285,270,283,3340700,928184448,255262,12,4.43 ,555.56 ,1643080,1697620
20131021,258,274,257,271,2690604,714665216,309802,13,5.04 ,661.48 ,1337461,1353143
20131018,261,264,261,262,168860,44286352,325484,1,0.38 ,114.94 ,89940,78920
20131017,264,269,259,261,2927426,774395456,314464,-3,-1.14 ,386.10 ,1464407,1463019
20131016,265,272,262,263,2701282,722970176,313076,-2,-0.75 ,381.68 ,1348841,1352441
20131015,261,268,259,265,2833564,744561856,316676,4,1.53 ,347.49 ,1416924,1416640
20131014,266,270,258,260,2825052,746433152,316392,-6,-2.26 ,465.12 ,1413991,1411061
20131011,269,273,264,266,2549170,684596992,313462,-3,-1.12 ,340.91 ,1273148,1276022
20131010,269,278,268,269,2497280,681180928,316336,0,0.00 ,373.13 ,1249820,1247460
20131009,256,272,256,269,2186250,577119296,313976,13,5.08 ,625.00 ,1093073,1093177
20131008,255,262,253,256,2412272,622087040,314080,1,0.39 ,355.73 ,1207558,1204714
20130930,257,259,253,254,1796572,460506336,311236,-3,-1.17 ,237.15 ,901982,894590
20130927,259,263,255,257,2024748,523785920,303844,-2,-0.77 ,313.73 ,1015648,1009100
20130926,260,263,257,259,1950946,507516352,297296,-1,-0.38 ,233.46 ,979025,971921
20130925,263,268,260,260,1670328,439849792,290192,-3,-1.14 ,307.69 ,839917,830411
20130924,260,266,259,263,1612116,423160640,280686,3,1.15 ,270.27 ,804193,807923
20130923,258,266,257,260,1404682,367519520,284416,2,0.78 ,350.19 ,704706,699976
20130918,260,263,256,258,1928282,500046176,279686,-2,-0.77 ,273.44 ,962477,965805
20130917,254,263,253,260,1133224,293129216,283014,6,2.36 ,395.26 ,560714,572510
20130916,249,256,247,254,1296916,325944480,294810,5,2.01 ,364.37 ,646313,650603
20130913,242,253,241,249,1526950,378733760,299100,7,2.89 ,497.93 ,749858,777092
20130912,237,242,232,242,1653962,391972896,326334,5,2.11 ,431.03 ,820557,833405
20130911,235,240,228,237,1392892,325199424,339182,2,0.85 ,526.32 ,683707,709185
20130910,240,243,235,235,1705806,406435840,364660,-5,-2.08 ,340.43 ,855824,849982
20130909,245,246,237,240,1525816,367542912,358818,-5,-2.04 ,379.75 ,764056,761760
20130906,244,250,242,245,1235240,304209952,356522,1,0.41 ,330.58 ,618175,617065
20130905,240,246,236,244,1345510,323289856,355412,4,1.67 ,423.73 ,678226,667284
20130904,241,246,238,240,1396936,337360192,344470,-1,-0.41 ,336.13 ,695832,701104
20130903,235,243,231,240,2051834,486373568,349742,5,2.13 ,519.48 ,1020551,1031283
20130902,237,240,231,235,2201246,516340352,360474,-2,-0.84 ,389.61 ,1101202,1100044
20130830,240,243,234,237,1410590,336011680,359316,-3,-1.25 ,384.62 ,696326,714264
20130829,234,246,233,240,1502572,358824128,377254,6,2.56 ,557.94 ,744667,757905
20130828,229,237,227,234,1584554,366851744,390492,5,2.18 ,440.53 ,795039,789515
20130827,232,234,222,229,1581236,360450464,384968,-3,-1.29 ,540.54 ,792403,788833
20130826,230,234,225,232,1340058,306955456,381398,2,0.87 ,400.00 ,676860,663198
20130823,240,242,224,230,1684546,391555392,367736,-10,-4.17 ,803.57 ,836736,847810
20130822,249,250,237,240,1653612,401023616,378810,-9,-3.61 ,548.52 ,822244,831368
20130821,251,254,244,249,1844410,459724832,387934,-2,-0.80 ,409.84 ,924468,919942
20130820,237,253,235,251,1515520,373338176,383408,14,5.91 ,765.96 ,759787,755733
20130819,237,242,227,237,1480626,346335552,379354,0,0.00 ,660.79 ,740268,740358
20130816,241,243,233,234,1438396,341743200,379444,-7,-2.90 ,429.18 ,720281,718115
20130815,239,247,237,241,1964980,475034144,377278,2,0.84 ,421.94 ,979237,985743
20130814,232,243,226,239,1311920,306165280,383784,7,3.02 ,752.21 ,660302,651618
20130813,230,236,226,232,1361596,315153952,375100,2,0.87 ,442.48 ,685342,676254
20130812,225,234,222,230,1146762,262199504,366012,5,2.22 ,540.54 ,579256,567506
20130809,222,228,218,225,1496258,335048384,354262,3,1.35 ,458.72 ,746071,750187
20130808,236,240,221,223,1476436,338158112,358378,-13,-5.51 ,859.73 ,735405,741031
20130807,234,239,228,236,1232294,286697152,364004,2,0.85 ,482.46 ,618167,614127
20130806,243,245,231,234,1285948,305380704,359964,-9,-3.70 ,606.06 ,644302,641646
20130805,252,254,240,245,1091458,269688064,357308,-7,-2.78 ,583.33 ,550152,541306
20130802,264,268,249,253,1076068,275964096,348462,-11,-4.17 ,763.05 ,533679,542389
20130801,265,268,256,264,1140824,300556128,357172,-1,-0.38 ,468.75 ,566002,574822
20130731,283,285,262,265,1580030,428518688,365992,-18,-6.36 ,877.86 ,790532,789498
20130730,282,288,277,283,1126196,318387360,364958,1,0.35 ,397.11 ,565352,560844
20130729,286,291,277,282,977590,279082848,360450,-4,-1.40 ,505.42 ,493476,484114
20130726,291,293,281,286,889032,255762512,351088,-5,-1.72 ,427.05 ,441168,447864
20130725,301,306,283,291,922454,268706784,357784,-10,-3.32 ,812.72 ,459567,462887
20130724,303,309,297,301,889616,270055232,361104,-2,-0.66 ,404.04 ,444230,445386
20130723,283,302,278,302,852386,249103392,362260,19,6.71 ,863.31 ,430701,421685
20130722,275,287,272,283,833724,233292224,353244,8,2.91 ,551.47 ,420212,413512
20130719,264,278,262,275,1067358,286497472,346544,11,4.17 ,610.69 ,531260,536098
20130718,257,268,254,264,927412,242388704,351382,7,2.72 ,551.18 ,469889,457523
20130717,263,270,258,258,892452,235233408,339016,-5,-1.90 ,465.12 ,454705,437747
20130716,280,284,265,265,782056,214285408,322058,-15,-5.36 ,716.98 ,401999,380057
20130715,294,299,278,280,940566,272577248,300116,-14,-4.76 ,755.40 ,479590,460976
20130712,278,293,275,293,823226,235850944,281502,15,5.40 ,654.55 ,418959,404267
20130711,268,278,264,278,953042,258014384,266810,10,3.73 ,530.30 ,486326,466716
20130710,269,280,266,268,952764,260342320,247200,-1,-0.37 ,526.32 ,483850,468914
20130709,254,270,252,269,849724,221260784,232264,15,5.91 ,714.29 ,434779,414945
20130708,266,275,248,254,1186172,310705632,212430,-12,-4.51 ,1088.71 ,597142,589030
20130705,273,274,259,266,1245500,330911584,204318,-7,-2.56 ,579.15 ,632384,613116
20130704,288,291,272,273,1058108,294937632,185050,-15,-5.21 ,698.53 ,529401,528707
20130703,296,302,286,288,1072674,317612512,184356,-8,-2.70 ,559.44 ,539258,533416
20130702,287,301,277,296,1041146,301241600,178514,9,3.14 ,866.43 ,524252,516894
20130701,300,304,279,287,1093232,322191776,171156,-13,-4.33 ,896.06 ,552686,540546
20130628,309,314,291,300,1036690,314926560,159016,-9,-2.91 ,790.38 ,525157,511533
20130627,296,316,294,309,1071068,325485568,145392,13,4.39 ,748.30 ,541230,529838
20130626,291,305,280,296,1179232,346025856,134000,5,1.72 ,892.86 ,593643,585589
20130625,309,313,285,291,954558,285566816,125946,-18,-5.83 ,982.46 ,484490,470068
20130624,306,314,299,309,844066,258188112,111524,3,0.98 ,501.67 ,423400,420666
20130621,312,316,297,306,964768,294488960,108790,-6,-1.92 ,639.73 ,484038,480730
20130620,330,334,314,314,913654,294986880,105482,-16,-4.85 ,636.94 ,454463,459191
20130619,345,351,327,330,864966,295411168,110210,-15,-4.35 ,733.94 ,447758,417208
20130618,365,372,339,345,687434,245257936,79660,-20,-5.48 ,973.45 ,364421,323013
20130617,350,370,334,365,436074,153565984,38252,15,4.29 ,1077.84 ,,
