20160621,375,390,372,384,2066700,794243712,527426,9,2.40 ,483.87 ,1058409,1008291
20160620,364,378,361,375,2530102,937308928,477308,11,3.02 ,470.91 ,1276489,1253613
20160617,341,368,335,364,5318332,1883285120,454432,23,6.74 ,985.07 ,2671750,2646582
20160616,355,358,340,341,1697750,588298368,429264,-14,-3.94 ,529.41 ,858949,838801
20160615,362,366,349,355,2192082,781886912,409116,-7,-1.93 ,487.11 ,1106475,1085607
20160614,353,365,345,362,2679940,949872704,388248,9,2.55 ,579.71 ,1339734,1340206
20160613,342,356,333,353,2511618,860955328,388720,11,3.22 ,690.69 ,1190130,1321488
20160612,354,356,334,343,3770260,1290004736,520078,-11,-3.11 ,658.68 ,1925452,1844808
20160608,353,365,336,354,4385854,1533900416,439434,1,0.28 ,863.10 ,2186203,2199651
20160607,375,378,351,353,5661178,2049258752,452882,-22,-5.87 ,769.23 ,2807482,2853696
20160606,388,390,373,375,2829274,1069141824,499096,-13,-3.35 ,455.76 ,1368706,1460568
20160603,415,416,385,388,4958830,1996726016,590958,-27,-6.51 ,805.19 ,2554219,2404611
20160602,414,417,403,415,2704812,1108790016,441350,1,0.24 ,347.39 ,1361102,1343710
20160601,409,420,400,414,2627398,1076316800,423958,5,1.22 ,500.00 ,1285941,1341457
20160531,430,435,404,409,2875352,1193048960,479474,-21,-4.88 ,767.33 ,1468362,1406990
20160530,417,431,416,428,2099948,892347392,418102,11,2.64 ,360.58 ,1038454,1061494
20160527,442,442,410,417,3878048,1640145664,441142,-25,-5.66 ,780.49 ,1943339,1934709
20160526,433,447,430,441,2711322,1187124992,432512,8,1.85 ,395.35 ,1348644,1362678
20160525,454,455,428,433,2416948,1055951808,446546,-21,-4.63 ,630.84 ,1182947,1234001
20160524,477,478,453,454,4464782,2055530496,497600,-23,-4.82 ,551.88 ,2231257,2233525
20160523,511,514,471,477,5069032,2465995008,499868,-34,-6.65 ,912.95 ,2599390,2469642
20160520,512,515,488,512,3503896,1760392064,370120,0,0.00 ,553.28 ,1760350,1743546
20160519,491,526,485,512,3725112,1885559936,353316,21,4.28 ,845.36 ,1871063,1854049
20160518,504,506,472,491,3629398,1766678784,336302,-13,-2.58 ,720.34 ,1790912,1838486
20160517,526,529,498,504,3880732,1974137088,383876,-22,-4.18 ,622.49 ,1938866,1941866
20160516,560,563,521,526,3794496,2044389248,386876,-34,-6.07 ,806.14 ,1898385,1896111
20160504,530,540,525,535,1031978,551086208,384602,5,0.94 ,285.71 ,521790,510188
20160503,504,533,494,530,2809576,1433182336,373000,26,5.16 ,789.47 ,1436082,1373494
20160429,493,517,490,504,1796092,899848000,310412,11,2.23 ,551.02 ,899631,896461
20160428,487,497,469,493,1986742,961569792,307242,6,1.23 ,597.01 ,973163,1013579
20160427,472,490,458,487,2546488,1200023808,347658,15,3.18 ,698.69 ,1287375,1259113
20160426,488,495,460,472,3074286,1458319360,319396,-16,-3.28 ,760.87 ,1529363,1544923
20160425,488,492,466,487,2363230,1136475904,334956,-1,-0.20 ,557.94 ,1154103,1209127
20160422,483,494,470,487,4958608,2393503232,389980,4,0.83 ,510.64 ,2481905,2476703
20160421,499,506,478,483,2821324,1381740800,384778,-16,-3.21 ,585.77 ,1384356,1436968
20160420,528,533,495,499,2719624,1383855744,437390,-29,-5.49 ,767.68 ,1319502,1400122
20160419,556,559,525,528,3595876,1924459392,518010,-28,-5.04 ,647.62 ,1808089,1787787
20160418,564,595,553,556,2174226,1232656768,497708,-8,-1.42 ,759.49 ,1166535,1007691
20160415,543,570,529,564,1864758,1033241792,338864,21,3.87 ,775.05 ,948107,916651
20160414,559,576,538,543,1734382,967847680,307408,-16,-2.86 ,706.32 ,849823,884559
20160413,588,593,555,560,1435826,828907584,342144,-28,-4.76 ,684.68 ,737709,698117
20160412,584,596,568,588,1692640,985847680,302552,4,0.68 ,492.96 ,848459,844181
20160411,575,590,567,584,906322,521706720,298274,9,1.57 ,405.64 ,445021,461301
20160408,574,578,572,575,196576,113039280,314554,1,0.17 ,104.90 ,97800,98776
20160407,582,583,573,574,186348,107680880,315530,-8,-1.37 ,174.52 ,92759,93589
20160406,578,584,576,582,227208,131774712,316360,4,0.69 ,138.89 ,112280,114928
20160405,578,580,575,578,217748,125746880,319008,0,0.00 ,86.96 ,108345,109403
20160401,581,582,575,578,261496,151277536,320066,-3,-0.52 ,121.74 ,130969,130527
20160331,584,586,580,581,264178,154025488,319624,-3,-0.51 ,103.45 ,131129,133049
20160330,586,589,583,584,278846,163495952,321544,-2,-0.34 ,102.92 ,139639,139207
20160329,589,590,585,586,278620,163757168,321112,-3,-0.51 ,85.47 ,139603,139017
20160328,590,593,587,590,255654,150677504,320526,0,0.00 ,102.21 ,128319,127335
20160325,597,597,589,590,292914,173940384,319542,-7,-1.17 ,135.82 ,148358,144556
20160324,604,605,595,597,247588,148392624,315740,-7,-1.16 ,168.07 ,123062,124526
20160323,608,610,602,604,265192,160597680,317204,-4,-0.66 ,132.89 ,132299,132893
20160322,608,610,603,608,272414,165244608,317798,0,0.00 ,116.09 ,136358,136056
20160321,604,610,604,608,260214,158039424,317496,4,0.66 ,99.34 ,129443,130771
20160318,597,605,596,604,252822,151976384,318824,7,1.17 ,151.01 ,126090,126732
20160317,591,599,589,597,252870,150382784,319466,6,1.02 ,169.78 ,127536,125334
20160316,594,597,589,591,253528,150234896,317264,-3,-0.51 ,135.82 ,125241,128287
20160315,587,596,586,594,258258,152865184,320310,7,1.19 ,170.65 ,129380,128878
20160314,589,590,584,587,191472,112426136,319808,-2,-0.34 ,102.74 ,96561,94911
20160311,589,594,588,589,317690,187867824,318158,0,0.00 ,102.04 ,158737,158953
20160310,592,595,588,589,278540,164698480,318374,-3,-0.51 ,119.05 ,139330,139210
20160309,597,599,589,592,260412,154574112,318254,-5,-0.84 ,169.78 ,132312,128100
20160308,597,600,594,597,248664,148398992,314042,0,0.00 ,101.01 ,123793,124871
20160307,598,602,595,597,254236,152221152,315120,-1,-0.17 ,117.65 ,126290,127946
20160304,592,599,591,598,271760,161599040,316776,6,1.01 ,135.36 ,135163,136597
20160303,588,594,584,592,266672,157255664,318210,4,0.68 ,171.23 ,132749,133923
20160302,595,596,586,588,260898,153982080,319384,-7,-1.18 ,170.65 ,131845,129053
20160301,587,596,586,595,255550,151252496,316592,8,1.36 ,170.65 ,126476,129074
20160229,587,590,584,587,260902,153297776,319190,0,0.00 ,102.74 ,129175,131727
20160226,589,593,586,587,259814,153225312,321742,-2,-0.34 ,119.45 ,130361,129453
20160225,592,595,588,589,261766,154891904,320834,-3,-0.51 ,119.05 ,130132,131634
20160224,594,596,587,590,250754,148005408,322336,-4,-0.67 ,153.32 ,123024,127730
20160223,592,597,592,594,200726,119372232,327042,2,0.34 ,84.46 ,104665,96061
20160219,587,593,586,592,257764,152144752,318438,5,0.85 ,119.45 ,129729,128035
20160218,581,588,580,587,245016,143229808,316744,6,1.03 ,137.93 ,123511,121505
20160217,581,583,576,581,272380,157900608,314738,0,0.00 ,121.53 ,136307,136073
20160216,582,587,580,581,250198,145842496,314504,-1,-0.17 ,120.69 ,124989,125209
20160215,584,588,581,582,230494,134605104,314724,-2,-0.34 ,120.48 ,115271,115223
20160214,579,585,578,584,172718,100543080,314676,5,0.86 ,121.11 ,88076,84642
20160206,572,580,571,579,221950,127665696,311242,7,1.22 ,157.62 ,110655,111295
20160205,574,577,570,572,261634,150046288,311882,-2,-0.35 ,122.81 ,131703,129931
20160204,571,575,567,574,250728,143149552,310110,3,0.53 ,141.09 ,125519,125209
20160203,565,572,564,571,262608,149216224,309800,6,1.06 ,141.84 ,129385,133223
20160202,555,566,554,565,252724,141407008,313638,10,1.80 ,216.61 ,126917,125807
20160201,551,556,550,555,279360,154509392,312528,4,0.73 ,109.09 ,139778,139582
20160129,542,552,542,551,271456,148748096,312332,9,1.66 ,184.50 ,135962,135494
20160128,540,544,536,542,260046,140320704,311864,2,0.37 ,149.25 ,129852,130194
20160127,545,547,539,540,278730,151419152,312206,-5,-0.92 ,148.42 ,139345,139385
20160126,550,551,543,545,283038,154617056,312246,-5,-0.91 ,147.33 ,141549,141489
20160125,560,561,549,550,300410,166519744,312186,-10,-1.79 ,218.58 ,150469,149941
20160122,566,568,558,560,300342,168916480,311658,-6,-1.06 ,179.21 ,150053,150289
20160121,561,567,559,566,290578,163654064,311894,5,0.89 ,143.11 ,145602,144976
20160120,555,563,554,561,300162,167787888,311268,6,1.08 ,162.45 ,150405,149757
20160119,559,562,552,555,320242,178209024,310620,-4,-0.72 ,181.16 ,160157,160085
20160118,556,560,552,559,280030,155560960,310548,3,0.54 ,144.93 ,138920,141110
20160115,554,557,552,556,300260,166632816,312738,2,0.36 ,90.58 ,150321,149939
20160114,547,555,546,554,309168,170323520,312356,7,1.28 ,164.84 ,155166,154002
20160113,541,548,538,547,300138,163002160,311192,6,1.11 ,185.87 ,150045,150093
20160112,549,550,540,541,278750,151828720,311240,-8,-1.46 ,185.19 ,139227,139523
20160111,555,556,548,549,311480,171641792,311536,-6,-1.08 ,145.99 ,155724,155756
20160108,557,561,554,555,291230,162314560,311568,-2,-0.36 ,126.35 ,145240,145990
20160107,560,562,554,557,301854,168178496,312318,-3,-0.54 ,144.40 ,151280,150574
20160106,554,562,551,560,290882,162078576,311612,6,1.08 ,199.64 ,145828,145054
20160105,559,561,552,554,284560,158384576,310838,-5,-0.89 ,163.04 ,142117,142443
20160104,559,563,557,559,229900,128725536,311164,0,0.00 ,107.72 ,114421,115479
20151231,552,561,552,559,302540,168212784,312222,7,1.27 ,163.04 ,153418,149122
20151230,551,554,547,553,372416,205348288,307926,2,0.36 ,127.97 ,188010,184406
20151229,557,558,549,551,300274,165903936,304322,-6,-1.08 ,163.93 ,149856,150418
20151228,555,559,552,557,301950,167835152,304884,2,0.36 ,126.81 ,147423,154527
20151225,552,558,551,555,343526,190570256,311988,3,0.54 ,127.04 ,170338,173188
20151224,552,553,547,552,338428,186214000,314838,0,0.00 ,109.69 ,168859,169569
20151223,557,560,550,552,293548,163016096,315548,-5,-0.90 ,181.82 ,150248,143300
20151222,558,561,555,557,343396,191568288,308600,-1,-0.18 ,108.11 ,171687,171709
20151221,562,563,556,558,294658,164861056,308622,-4,-0.71 ,125.90 ,147987,146671
20151218,558,565,557,562,308300,172980544,307306,4,0.72 ,143.63 ,148935,159365
20151217,550,559,549,558,464932,257401104,317736,8,1.45 ,182.15 ,228714,236218
20151216,550,553,546,550,337358,185448432,325240,0,0.00 ,128.21 ,168445,168913
20151215,550,554,547,550,361926,199088608,325708,0,0.00 ,127.97 ,177908,184018
20151214,551,554,548,550,348460,192015184,331818,-1,-0.18 ,109.49 ,174069,174391
20151211,549,552,546,551,330034,181263648,332140,2,0.36 ,109.89 ,164897,165137
20151210,550,552,546,549,341036,187252304,332380,-1,-0.18 ,109.89 ,171082,169954
20151209,550,552,545,550,346336,189953552,331252,0,0.00 ,128.44 ,174050,172286
20151208,551,554,547,550,351790,193647648,329488,-1,-0.18 ,127.97 ,175513,176277
20151207,550,556,550,551,339494,187672848,330252,1,0.18 ,109.09 ,169292,170202
20151204,546,553,545,550,353194,194106144,331162,4,0.73 ,146.79 ,173616,179578
20151203,542,549,541,546,369152,201460000,337124,4,0.74 ,147.87 ,184338,184814
20151202,545,548,541,542,371042,201901632,337600,-3,-0.55 ,129.39 ,185142,185900
20151201,540,547,537,545,384064,207920160,338358,5,0.93 ,186.22 ,192379,191685
20151130,542,546,538,540,341432,185134096,337664,-2,-0.37 ,148.70 ,169926,171506
20151127,533,543,533,542,360080,193646784,339244,9,1.69 ,187.62 ,179631,180449
20151126,530,534,527,533,359260,190344816,340062,3,0.57 ,132.83 ,179823,179437
20151125,524,531,523,530,377934,199279040,339676,6,1.15 ,152.96 ,189328,188606
20151124,526,528,522,524,370686,194493008,338954,-2,-0.38 ,114.94 ,184778,185908
20151123,525,531,523,526,331184,174688704,340084,1,0.19 ,152.96 ,163320,167864
20151120,530,531,524,525,358944,189088880,344628,-5,-0.94 ,133.59 ,178467,180477
20151119,536,537,529,530,374784,199306288,346638,-6,-1.12 ,151.23 ,187509,187275
20151118,536,540,534,536,387056,207765440,346404,0,0.00 ,112.36 ,192322,194734
20151117,530,537,526,536,371646,197049680,348816,6,1.13 ,209.13 ,185405,186241
20151116,528,531,525,530,385802,203882240,349652,2,0.38 ,114.29 ,193893,191909
20151113,530,532,525,528,369408,195105392,347668,-2,-0.38 ,133.33 ,186071,183337
20151112,526,532,526,530,382364,202280432,344934,4,0.76 ,114.07 ,191245,191119
20151111,524,528,521,526,369566,193855968,344808,2,0.38 ,134.36 ,185427,184139
20151110,518,525,516,524,361906,188559008,343520,6,1.16 ,174.42 ,182099,179807
20151109,517,521,515,518,250888,129940984,341228,1,0.19 ,116.50 ,124927,125961
20151106,518,521,512,517,382482,197647616,342262,-1,-0.19 ,175.78 ,191794,190688
20151105,520,525,516,518,374288,194709184,341156,-2,-0.38 ,174.42 ,185588,188700
20151104,523,525,517,519,351824,183390848,344268,-4,-0.76 ,154.74 ,175808,176016
20151103,520,525,517,523,363234,189197488,344476,3,0.58 ,154.74 ,181255,181979
20151102,522,526,518,520,385486,201471424,345200,-2,-0.38 ,154.44 ,192322,193164
20151030,517,524,516,522,351674,182932352,346042,5,0.97 ,155.04 ,176139,175535
20151029,511,519,511,517,366866,189142256,345438,6,1.17 ,156.56 ,183123,183743
20151028,503,512,502,511,351484,178274848,346058,8,1.59 ,199.20 ,175755,175729
20151027,496,506,495,503,376792,188316800,346032,7,1.41 ,222.22 ,187438,189354
20151026,493,499,491,497,371134,183865104,347948,4,0.81 ,162.93 ,184881,186253
20151023,498,501,492,493,348192,172970432,349320,-5,-1.00 ,182.93 ,174487,173705
20151022,494,499,491,498,361014,178675648,348538,4,0.81 ,162.93 ,181374,179640
20151021,495,501,493,494,373674,185752832,346804,-1,-0.20 ,162.27 ,187094,186580
20151020,492,496,488,495,353624,174145984,346290,3,0.61 ,163.93 ,176349,177275
20151019,503,504,490,492,362334,179914576,347216,-11,-2.19 ,285.71 ,182108,180226
20151016,511,512,502,503,380944,192820432,345334,-8,-1.57 ,199.20 ,188049,192895
20151015,507,514,507,511,370588,189150800,350180,4,0.79 ,138.07 ,184837,185751
20151014,508,512,505,507,380580,193454928,351094,-1,-0.20 ,138.61 ,189556,191024
20151013,507,513,506,508,368378,187564208,352562,1,0.20 ,138.34 ,183923,184455
20151012,499,508,498,507,387852,195488032,353094,8,1.60 ,200.80 ,194383,193469
20151011,499,503,498,502,97064,48583080,352180,3,0.60 ,100.40 ,48461,48603
20151010,497,502,495,499,388364,193492992,352322,2,0.40 ,141.41 ,192513,195851
20151009,494,499,492,497,352100,174453200,355660,3,0.61 ,142.28 ,176258,175842
20151008,498,499,493,494,237672,117890216,355244,-4,-0.80 ,121.70 ,117597,120075
20150930,502,504,496,498,381382,190895616,357722,-4,-0.80 ,161.29 ,188809,192573
20150929,495,503,495,501,375254,187261536,361486,6,1.21 ,161.62 ,188273,186981
20150928,490,496,487,495,366850,180234080,360194,5,1.02 ,184.80 ,184012,182838
20150925,485,492,483,490,378544,184702816,359020,5,1.03 ,186.34 ,188682,189862
20150924,483,486,479,485,385372,185935984,360200,2,0.41 ,146.14 ,191357,194015
20150923,492,494,482,483,408264,198910480,362858,-9,-1.83 ,248.96 ,205064,203200
20150922,488,493,485,492,326760,159698320,360994,4,0.82 ,164.95 ,165624,161136
20150921,483,491,480,488,385490,187097632,356506,5,1.04 ,229.17 ,190299,195191
20150918,491,493,481,483,372548,180938512,361398,-8,-1.63 ,249.48 ,186796,185752
20150917,494,498,490,491,390698,192900320,360354,-3,-0.61 ,163.27 ,194491,196207
20150916,490,496,487,495,380400,187117760,362070,5,1.02 ,184.80 ,186176,194224
20150915,486,493,484,490,372366,182060192,370118,4,0.82 ,185.95 ,186637,185729
20150914,482,487,478,486,391120,188854752,369210,4,0.83 ,188.28 ,195441,195679
20150912,482,483,478,479,75660,36382592,369448,-3,-0.62 ,104.60 ,36798,38862
20150911,479,485,475,482,397914,191152736,371512,3,0.63 ,210.53 ,198987,198927
20150910,483,485,477,478,227004,109221232,371452,-5,-1.04 ,167.71 ,112485,114519
20150909,478,486,476,483,395016,190000448,373486,5,1.05 ,210.08 ,198199,196817
20150908,482,484,476,478,400278,191972480,372104,-4,-0.83 ,168.07 ,201727,198551
20150907,481,484,477,482,430794,206997424,368928,1,0.21 ,146.75 ,217456,213338
20150906,485,486,479,481,195084,94033896,364810,-4,-0.82 ,146.14 ,95218,99866
20150902,484,493,483,485,388634,189495168,369458,1,0.21 ,207.04 ,193653,194981
20150901,478,486,474,484,390606,187062384,370786,6,1.26 ,253.16 ,194971,195635
20150831,467,479,466,477,417122,197311552,371450,10,2.14 ,278.97 ,208221,208901
20150828,468,470,462,465,229566,107020272,372130,-3,-0.64 ,173.16 ,114669,114897
20150827,464,471,462,468,414356,193551728,372358,4,0.86 ,194.81 ,206989,207367
20150826,466,469,462,464,381332,177539744,372736,-2,-0.43 ,151.52 ,189214,192118
20150825,473,474,465,466,395680,185214160,375640,-7,-1.48 ,193.55 ,196601,199079
20150824,468,473,466,471,163256,76625736,378118,3,0.64 ,150.21 ,81454,81802
20150821,474,475,465,468,412092,194015552,378466,-6,-1.27 ,215.05 ,206125,205967
20150820,465,475,465,474,402748,190235632,378308,9,1.94 ,215.05 ,203177,199571
20150819,462,470,459,469,436250,202678096,374702,7,1.52 ,239.65 ,220632,215618
20150818,461,465,457,462,426276,196433616,369688,1,0.22 ,175.05 ,211627,214649
20150817,460,464,457,461,441298,203316160,372710,1,0.22 ,153.17 ,222324,218974
20150814,465,466,458,460,488462,225455072,369360,-5,-1.08 ,174.67 ,244074,244388
20150813,468,469,462,465,491346,228666112,369674,-3,-0.64 ,151.52 ,244030,247316
20150812,467,472,466,469,552810,259379376,372960,2,0.43 ,128.76 ,275729,277081
20150811,466,469,464,467,590714,275664352,374312,1,0.21 ,107.76 ,295743,294971
20150810,461,467,460,466,619846,287434656,373540,5,1.08 ,152.17 ,311373,308473
20150807,454,462,451,461,681044,311371520,370640,7,1.54 ,243.90 ,341785,339259
20150806,459,463,453,454,760680,348779872,368114,-5,-1.09 ,220.75 ,379425,381255
20150805,461,462,457,459,704062,323284000,369944,-2,-0.43 ,109.41 ,352223,351839
20150804,458,463,455,461,721398,331343008,369560,3,0.66 ,175.82 ,361161,360237
20150803,457,461,453,458,740414,337976320,368636,1,0.22 ,176.60 ,369738,370676
20150731,457,460,454,457,685296,313151616,369574,0,0.00 ,132.16 ,341860,343436
20150730,460,461,454,457,754292,344669120,371150,-3,-0.65 ,154.19 ,376979,377313
20150729,450,461,448,460,717526,326399552,371484,10,2.22 ,290.18 ,359296,358230
20150728,452,454,447,449,606480,272829440,370418,-3,-0.66 ,156.60 ,303380,303100
20150727,451,457,449,452,676698,306297024,370138,1,0.22 ,178.17 ,339771,336927
20150724,449,453,447,450,680556,306258496,367294,1,0.22 ,134.23 ,340374,340182
20150723,446,452,440,449,662800,295873344,367102,3,0.67 ,272.73 ,330025,332775
20150722,450,453,447,448,442398,199055280,369852,-2,-0.44 ,134.23 ,220573,221825
20150721,448,456,446,450,660354,298046016,371104,2,0.45 ,224.22 ,327484,332870
20150720,452,453,445,448,614374,275697248,376490,-4,-0.88 ,179.78 ,307234,307140
20150717,449,453,447,452,622204,279654176,376396,3,0.67 ,134.23 ,311377,310827
20150716,445,452,444,449,637752,286087936,375846,4,0.90 ,180.18 ,319686,318066
20150715,442,447,439,445,610386,270315360,374226,3,0.68 ,182.23 ,305789,304597
20150714,435,444,434,442,603352,265040720,373034,7,1.61 ,230.41 ,300921,302431
20150713,432,439,432,435,551342,240282320,374544,3,0.69 ,162.04 ,277971,273371
20150710,432,438,430,432,531030,230009952,369944,0,0.00 ,186.05 ,266522,264508
20150709,439,441,430,432,496032,215702112,367930,-7,-1.59 ,255.81 ,249989,246043
20150708,437,440,432,439,481104,209755904,363984,2,0.46 ,185.19 ,244506,236598
20150707,447,447,435,437,434306,190726080,356076,-10,-2.24 ,275.86 ,216012,218294
20150706,458,459,447,448,384566,174222448,358358,-10,-2.18 ,268.46 ,196903,187663
20150703,459,463,456,458,407590,187198544,349118,-1,-0.22 ,153.51 ,202677,204913
20150702,456,461,455,459,413164,189065440,351354,3,0.66 ,131.87 ,209878,203286
20150701,450,457,449,456,411600,186436080,344762,6,1.33 ,178.17 ,208169,203431
20150630,451,453,447,450,424342,191021552,340024,-1,-0.22 ,134.23 ,211686,212656
20150629,450,453,447,451,417322,187740816,340994,1,0.22 ,134.23 ,210192,207130
20150626,453,454,448,450,400584,180532080,337932,-3,-0.66 ,133.93 ,199615,200969
20150625,455,457,450,453,423300,191967248,339286,-2,-0.44 ,155.56 ,211227,212073
20150624,451,457,450,455,407620,185017664,340132,4,0.89 ,155.56 ,203502,204118
20150623,449,452,447,451,307864,138456880,340748,2,0.45 ,111.86 ,154464,153400
20150619,448,450,444,449,423632,189329600,339684,1,0.22 ,135.14 ,214094,209538
20150618,450,453,447,448,416116,187180160,335128,-2,-0.44 ,134.23 ,210296,205820
20150617,448,454,447,450,403948,181915760,330652,2,0.45 ,156.60 ,199813,204135
20150616,443,449,442,448,437398,195032224,334974,5,1.13 ,158.37 ,216614,220784
20150615,445,449,441,443,436430,194206880,339144,-2,-0.45 ,181.41 ,218776,217654
20150612,437,446,437,445,469862,207871600,338022,8,1.83 ,205.95 ,238608,231254
20150611,438,441,434,437,457142,200056208,330668,-1,-0.23 ,161.29 ,232808,224334
20150610,442,442,436,438,486310,213373760,322194,-4,-0.90 ,137.61 ,241775,244535
20150609,442,446,440,442,458066,202904368,324954,0,0.00 ,136.36 ,230180,227886
20150608,438,444,437,442,505406,222672464,322660,4,0.91 ,160.18 ,253762,251644
20150605,435,440,431,438,503842,219582432,320542,3,0.69 ,208.82 ,253639,250203
20150604,438,441,432,434,478530,208856944,317106,-4,-0.91 ,208.33 ,233682,244848
20150603,435,439,434,438,477680,208607952,328272,3,0.69 ,115.21 ,233789,243891
20150602,432,437,431,435,490954,212926112,338374,3,0.69 ,139.21 ,246604,244350
20150601,430,435,428,432,489008,211032704,336120,2,0.47 ,163.55 ,242952,246056
20150529,431,435,429,430,481594,208007088,339224,-1,-0.23 ,139.86 ,240873,240721
20150528,424,432,423,431,492598,211277264,339072,7,1.65 ,212.77 ,248515,244083
20150527,421,426,420,424,532302,225379872,334640,3,0.71 ,142.86 ,267376,264926
20150526,421,424,419,421,584726,246644928,332190,0,0.00 ,119.33 ,293448,291278
20150525,415,422,412,421,552014,230724608,330020,6,1.45 ,242.72 ,275900,276114
20150522,417,418,411,415,536326,222133424,330234,-2,-0.48 ,170.32 ,267931,268395
20150521,422,423,415,417,578198,242375936,330698,-5,-1.18 ,192.77 ,288412,289786
20150520,419,424,418,422,554648,233845104,332072,3,0.72 ,143.54 ,279717,274931
20150519,417,422,415,419,586658,245447952,327286,2,0.48 ,168.67 ,292754,293904
20150518,414,419,412,417,595090,247514464,328436,3,0.72 ,169.90 ,296429,298661
20150515,416,419,412,414,527552,219257360,330668,-2,-0.48 ,169.90 ,261986,265566
20150514,413,418,411,416,611660,253376752,334248,3,0.73 ,170.32 ,305814,305846
20150513,412,415,408,413,586734,241449360,334280,1,0.24 ,171.57 ,293701,293033
20150512,413,414,407,411,583966,239646464,333612,-2,-0.48 ,171.99 ,290684,293282
20150511,411,414,407,413,563032,231063856,336210,2,0.49 ,171.99 ,281567,281465
20150508,415,418,410,411,554018,229295120,336108,-4,-0.96 ,195.12 ,275567,278451
20150507,414,416,411,415,565346,233791264,338992,1,0.24 ,121.65 ,279105,286241
20150506,410,416,409,414,597528,246666928,346128,4,0.98 ,171.15 ,297330,300198
20150505,406,412,403,410,578628,235891216,348996,4,0.99 ,223.33 ,292185,286443
20150504,408,410,404,406,418956,170516864,343254,-2,-0.49 ,148.51 ,208493,210463
20150430,411,413,407,408,558954,229100416,345224,-3,-0.73 ,147.42 ,278654,280300
20150429,410,414,407,411,561452,230507472,346870,1,0.24 ,171.99 ,282399,279053
20150428,405,412,404,410,685946,279734496,343524,5,1.23 ,198.02 ,345169,340777
20150427,399,407,397,405,606926,244315232,339132,6,1.50 ,251.89 ,304252,302674
20150424,401,405,398,399,612794,245966832,337554,-2,-0.50 ,175.88 ,306054,306740
20150423,404,406,396,401,585802,234511696,338240,-3,-0.74 ,252.53 ,293903,291899
20150422,401,407,400,404,611758,247305600,336236,3,0.75 ,175.00 ,306787,304971
20150421,402,403,397,401,597132,238823808,334420,-1,-0.25 ,151.13 ,300048,297084
20150420,400,404,398,402,598424,239998896,331456,2,0.50 ,150.75 ,296473,301951
20150417,392,402,391,400,642960,255594288,336934,8,2.04 ,281.33 ,322759,320201
20150416,384,393,383,392,580004,225452144,334376,8,2.08 ,261.10 ,288420,291584
20150415,390,391,383,384,642164,248461136,337540,-6,-1.54 ,208.88 ,322507,319657
20150414,391,395,389,390,662246,259676496,334690,-1,-0.26 ,154.24 ,332051,330195
20150413,388,393,385,391,634224,246767440,332834,3,0.77 ,207.79 ,316232,317992
20150410,384,391,383,388,663874,257488736,334594,4,1.04 ,208.88 ,331710,332164
20150409,382,387,379,385,580702,222482944,335048,3,0.79 ,211.08 ,291004,289698
20150408,381,385,379,382,620370,237126272,333742,1,0.26 ,158.31 ,306470,313900
20150407,388,389,378,381,400996,153256144,341172,-7,-1.80 ,291.01 ,203983,197013
20150403,391,395,386,388,626422,244210864,334202,-3,-0.77 ,233.16 ,304005,322417
20150402,391,394,388,391,627126,245156048,352614,0,0.00 ,154.64 ,307996,319130
20150401,388,395,386,391,612516,239221040,363748,3,0.77 ,233.16 ,299286,313230
20150331,393,394,385,388,605784,235123472,377692,-5,-1.27 ,233.77 ,294823,310961
20150330,396,397,391,393,658684,259424592,393830,-3,-0.76 ,153.45 ,325316,333368
20150327,401,401,391,396,633206,250233120,401882,-5,-1.25 ,255.75 ,318300,314906
20150326,394,402,393,401,589694,233804912,398488,7,1.78 ,229.01 ,302220,287474
20150325,391,396,386,394,595156,233141040,383742,3,0.77 ,259.07 ,297389,297767
20150324,391,395,389,391,623690,244536064,384120,0,0.00 ,154.24 ,310802,312888
20150323,389,393,386,391,592534,230844416,386206,2,0.51 ,181.35 ,298097,294437
20150320,389,392,387,389,633784,246838544,382546,0,0.00 ,129.20 ,314049,319735
20150319,390,393,387,389,690214,269323488,388232,-1,-0.26 ,155.04 ,343940,346274
20150318,386,392,385,390,635318,246836640,390566,4,1.04 ,181.82 ,316842,318476
20150317,386,388,382,386,597458,230031312,392200,0,0.00 ,157.07 ,301855,295603
20150316,387,389,384,386,401030,155046016,385948,-1,-0.26 ,130.21 ,198623,202407
20150313,386,389,385,387,623982,241551632,389732,1,0.26 ,103.90 ,312301,311681
20150312,387,389,385,386,454494,175869472,389112,-1,-0.26 ,103.90 ,225679,228815
20150311,384,387,383,387,429760,165510336,392248,3,0.78 ,104.44 ,214753,215007
20150310,391,393,383,384,601436,233196560,392502,-7,-1.79 ,261.10 ,298976,302460
20150309,389,392,386,391,569260,221198048,395986,2,0.51 ,155.44 ,285044,284216
20150306,388,391,387,389,599916,233551920,395158,1,0.26 ,103.36 ,293110,306806
20150305,389,391,387,388,546052,212423520,408854,-1,-0.26 ,103.36 ,272808,273244
20150304,390,392,388,389,586418,228557408,409290,-1,-0.26 ,103.09 ,288510,297908
20150303,405,405,392,393,553410,219423536,418688,-12,-2.96 ,331.63 ,270201,283209
20150302,416,416,407,408,600608,246452592,431696,-8,-1.92 ,221.13 ,299990,300618
20150301,416,416,409,413,235162,96928440,432324,-3,-0.72 ,171.15 ,114894,120268
20150228,428,429,416,417,626532,264048912,437698,-11,-2.57 ,312.50 ,314258,312274
20150227,438,439,427,428,653402,281645248,435714,-10,-2.28 ,281.03 ,327670,325732
20150226,438,442,436,438,623390,273569728,433776,0,0.00 ,137.61 ,310021,313369
20150225,441,442,437,438,538928,236829344,437124,-3,-0.68 ,114.42 ,269504,269424
20150217,437,444,436,441,503068,221334544,437044,4,0.92 ,183.49 ,252550,250518
20150216,436,439,434,437,648616,283376960,435012,1,0.23 ,115.21 ,324690,323926
20150215,435,439,433,436,441564,192491968,434248,1,0.23 ,138.57 ,218834,222730
20150213,434,437,429,435,602296,260897744,438144,1,0.23 ,186.48 ,305149,297147
20150212,437,439,432,434,631294,274532704,430142,-3,-0.69 ,162.04 ,313205,318089
20150211,435,439,432,437,664046,288843744,435026,2,0.46 ,162.04 ,330962,333084
20150210,432,437,429,435,683704,296213280,437148,3,0.69 ,186.48 ,345776,337928
20150209,429,434,426,432,652168,280618336,429300,3,0.70 ,187.79 ,329163,323005
20150206,437,438,428,429,693368,300241792,423142,-8,-1.83 ,233.64 ,348704,344664
20150205,448,448,436,437,671134,296276160,419102,-11,-2.46 ,275.23 ,337520,333614
20150204,442,449,441,448,600846,267706912,415196,6,1.36 ,181.41 ,303267,297579
20150203,448,451,441,442,654420,292090848,409508,-6,-1.34 ,226.76 ,322883,331537
20150202,448,450,444,448,629784,281527296,418162,0,0.00 ,135.14 ,307940,321844
20150130,455,456,447,448,608608,275259360,432066,-7,-1.54 ,201.34 ,305955,302653
20150129,456,460,453,455,636976,290674368,428764,-1,-0.22 ,154.53 ,316543,320433
20150128,451,458,450,456,658668,299192992,432654,5,1.11 ,177.78 ,337845,320823
20150127,456,457,447,450,630668,284798432,415632,-6,-1.32 ,223.71 ,309679,320989
20150126,456,458,451,456,680308,309409952,426942,0,0.00 ,155.21 ,342652,337656
20150123,460,462,455,456,633008,290193056,421946,-4,-0.87 ,153.85 ,309838,323170
20150122,463,464,456,460,650102,299244832,435278,-3,-0.65 ,175.44 ,324783,325319
20150121,470,471,462,463,621474,289559520,435814,-7,-1.49 ,194.81 ,305996,315478
20150120,469,472,465,470,685694,321429280,445296,1,0.21 ,150.54 ,349679,336015
20150119,469,473,467,469,650842,305805408,431632,0,0.00 ,128.48 ,326362,324480
20150116,472,474,467,469,704268,331289056,429750,-3,-0.64 ,149.89 ,354032,350236
20150115,475,482,470,472,753906,358849600,425954,-3,-0.63 ,255.32 ,374405,379501
20150114,479,481,473,475,829388,395702848,431050,-4,-0.84 ,169.13 ,413633,415755
20150113,485,485,477,479,761918,366140320,433172,-6,-1.24 ,167.71 ,378676,383242
20150112,482,487,479,485,816896,394376608,437738,3,0.62 ,167.01 ,407474,409422
20150109,480,485,478,482,830402,399832096,439686,2,0.42 ,146.44 ,412391,418011
20150108,481,485,478,480,942594,453948032,445306,-1,-0.21 ,146.44 ,471721,470873
20150107,483,484,478,481,747100,359457312,444458,-2,-0.41 ,125.52 ,373603,373497
20150106,488,489,481,483,798468,387739008,444352,-5,-1.02 ,166.32 ,397882,400586
20150105,486,491,484,488,770032,375071648,447056,2,0.41 ,144.63 ,386281,383751
20150104,483,488,481,486,619686,300028480,444526,3,0.62 ,145.53 ,311774,307912
20141231,487,488,481,483,898822,435689472,440664,-4,-0.82 ,145.53 ,449954,448868
20141230,491,492,485,487,886450,432916800,439578,-4,-0.81 ,144.33 ,443806,442644
20141229,490,495,488,491,1124790,552855488,438416,1,0.20 ,143.44 ,562420,562370
20141226,493,494,487,490,910016,446448000,438366,-3,-0.61 ,143.74 ,447642,462374
20141225,493,498,491,493,870164,430259296,453098,0,0.00 ,142.57 ,430537,439627
20141224,498,500,490,493,911368,451523232,462188,-5,-1.00 ,204.08 ,466743,444625
20141223,495,500,492,498,1113104,551823232,440070,3,0.61 ,162.60 ,566274,546830
20141222,500,501,492,495,1218658,604216384,420626,-5,-1.00 ,182.93 ,609192,609466
20141219,500,507,497,500,1075206,539555200,420900,0,0.00 ,201.21 ,540527,534679
20141218,494,503,492,500,1100614,547965376,415052,6,1.21 ,223.58 ,552471,548143
20141217,489,495,486,494,1048838,514056896,410724,5,1.02 ,185.19 ,524775,524063
20141216,490,494,486,489,993936,486947232,410012,-1,-0.20 ,164.61 ,496618,497318
20141215,484,494,484,490,776996,379524992,410712,6,1.24 ,206.61 ,389652,387344
20141212,484,489,480,484,908026,439707648,408404,0,0.00 ,187.50 ,455989,452037
20141211,480,487,477,484,690142,332667296,404452,4,0.83 ,209.64 ,344165,345977
20141210,474,482,473,480,601986,288192384,406264,6,1.27 ,190.27 ,300410,301576
20141209,474,477,469,474,752228,356211136,407430,0,0.00 ,170.58 ,375373,376855
20141208,469,476,468,474,842186,397711072,408912,5,1.07 ,170.94 ,418075,424111
20141205,473,476,467,469,1004094,473353088,414948,-4,-0.85 ,192.72 ,507896,496198
20141204,472,475,469,473,702670,331164000,403250,1,0.21 ,127.93 ,333884,368786
20141203,474,476,470,472,1002170,474315456,438152,-2,-0.42 ,127.66 ,486528,515642
20141202,482,484,473,474,700334,334205216,467266,-8,-1.66 ,232.56 ,324608,375726
20141201,487,489,479,482,900376,435812000,518384,-5,-1.03 ,208.77 ,450255,450121
20141128,491,493,485,487,1230096,601214272,518250,-4,-0.81 ,164.95 ,612269,617827
20141127,493,496,487,491,1502730,738322688,523808,-2,-0.41 ,184.80 ,757096,745634
20141126,491,495,487,493,900134,442018400,512346,2,0.41 ,164.27 ,447689,452445
20141125,491,494,488,491,1010762,496813440,517102,0,0.00 ,122.95 ,496581,514181
20141124,491,494,486,491,1410196,691060544,534702,0,0.00 ,164.61 ,708945,701251
20141121,500,502,490,491,1208918,599875584,527008,-9,-1.80 ,244.90 ,596620,612298
20141120,496,504,496,500,1440304,720186112,542686,4,0.81 ,161.29 ,724988,715316
20141119,491,498,490,496,1210054,598526720,533014,5,1.02 ,163.27 ,600756,609298
20141118,485,493,485,491,1419490,693632384,541556,6,1.24 ,164.95 ,709169,710321
20141117,480,489,480,485,1299958,630608064,542708,5,1.04 ,187.50 ,656822,643136
20141114,482,483,475,480,1203610,576785472,529022,-2,-0.41 ,168.42 ,595340,608270
20141113,482,486,479,482,1411152,680827712,541952,0,0.00 ,146.14 ,711372,699780
20141112,484,485,477,482,1245364,598581184,530360,-2,-0.41 ,167.71 ,619031,626333
20141111,482,486,479,484,1433490,691829184,537662,2,0.41 ,146.14 ,719242,714248
20141110,487,488,480,482,1346790,653014336,532668,-5,-1.03 ,166.67 ,672386,674404
20141107,493,494,485,487,1244772,609344896,534686,-6,-1.22 ,185.57 ,625866,618906
20141106,492,498,491,493,1256076,620377408,527726,1,0.20 ,142.57 ,629722,626354
20141105,485,496,484,492,1289590,631977664,524358,7,1.44 ,247.93 ,640199,649391
20141104,485,487,479,485,1343872,649647424,533550,0,0.00 ,167.01 ,669233,674639
20141103,491,493,483,485,1345472,656920832,538956,-6,-1.22 ,207.04 ,670554,674918
20141031,485,494,484,491,1384480,678233856,543320,6,1.24 ,206.61 ,702962,681518
20141030,484,488,479,485,1365888,659978624,521876,1,0.21 ,187.89 ,689711,676177
20141029,483,488,480,484,1394036,674052864,508342,1,0.21 ,166.67 ,703127,690909
20141028,479,487,476,483,1373954,661723968,496124,4,0.84 ,231.09 ,652719,721235
20141027,472,481,470,479,1354988,645335680,564640,7,1.48 ,234.04 ,648119,706869
20141024,478,479,469,471,1164468,551002432,623390,-7,-1.46 ,213.22 ,579760,584708
20141023,488,488,477,478,1400288,675352192,628338,-10,-2.05 ,230.61 ,703352,696936
20141022,502,503,487,488,1343288,665967488,621922,-14,-2.79 ,328.54 ,665549,677739
20141021,501,507,496,502,1431634,717044928,634112,1,0.20 ,221.77 ,720642,710992
20141020,510,511,500,501,973506,491898624,624462,-9,-1.76 ,220.00 ,482883,490623
20141017,510,513,503,510,950496,483158720,632202,0,0.00 ,198.81 ,453592,496904
20141016,527,528,509,510,1060626,548321280,675514,-17,-3.23 ,373.28 ,506700,553926
20141015,536,538,523,527,1097166,580701504,722740,-9,-1.68 ,286.81 ,517992,579174
20141014,532,542,531,536,1459306,784321088,783922,4,0.75 ,207.16 ,729602,729704
20141013,526,536,525,533,1088022,578092800,784024,7,1.33 ,209.52 ,540010,548012
20141011,521,528,520,526,1280746,670910976,792026,5,0.96 ,153.85 ,634671,646075
20141010,518,523,515,521,1780718,923853056,803430,3,0.58 ,155.34 ,885047,895671
20141009,517,523,514,518,2579778,1339334528,814054,1,0.19 ,175.10 ,1286099,1293679
20141008,509,518,508,517,1667676,855813312,821634,8,1.57 ,196.85 ,828921,838755
20140930,506,511,504,509,2255708,1146717440,831468,3,0.59 ,138.89 ,1119966,1135742
20140929,506,508,501,506,2968698,1500263168,847244,0,0.00 ,139.72 ,1480798,1487900
20140928,508,510,503,506,3436326,1740536320,854346,-2,-0.39 ,139.17 ,1718921,1717405
20140927,508,510,505,507,1185216,601201280,852830,-1,-0.20 ,99.01 ,592596,592620
20140926,505,512,504,508,3315216,1685440256,852854,3,0.59 ,158.73 ,1659376,1655840
20140925,505,509,502,505,3600550,1818463744,849318,0,0.00 ,139.44 ,1803239,1797311
20140924,498,505,495,505,3406902,1703826688,843390,7,1.41 ,202.02 ,1699916,1706986
20140923,500,504,497,498,3401608,1702039168,850460,-2,-0.40 ,140.85 ,1701117,1700491
20140922,493,500,490,500,3441634,1702846976,849834,7,1.42 ,204.08 ,1723259,1718375
20140919,488,498,488,493,2973124,1468526464,844950,5,1.02 ,204.92 ,1483575,1489549
20140918,477,490,476,488,3372720,1626095872,850924,11,2.31 ,294.12 ,1682867,1689853
20140917,472,479,471,477,3635938,1726477824,857910,5,1.06 ,169.85 ,1819153,1816785
20140916,465,474,461,472,4547996,2120973568,855542,7,1.51 ,282.00 ,2273498,2274498
20140915,467,474,465,465,5472256,2572067840,856542,-2,-0.43 ,193.55 ,2741131,2731125
20140912,461,469,458,467,5596996,2593467136,846536,6,1.30 ,240.17 ,2802383,2794613
20140911,459,465,458,461,5300210,2444353024,838766,2,0.44 ,152.84 ,2650390,2649820
20140910,452,461,449,459,5023700,2289038848,838196,7,1.55 ,267.26 ,2516744,2506956
20140909,448,453,445,451,2536650,1137161472,828408,3,0.67 ,179.78 ,1273991,1262659
20140905,451,451,444,448,5348916,2393180416,817076,-3,-0.67 ,157.66 ,2680684,2668232
20140904,450,452,445,451,5656826,2538339840,804624,1,0.22 ,157.30 ,2835958,2820868
20140903,445,455,444,450,5287798,2378321408,789534,5,1.12 ,247.75 ,2653834,2633964
20140902,443,447,438,445,5479154,2423483392,769664,2,0.45 ,205.48 ,2744788,2734366
20140901,445,452,442,443,4930964,2203077376,759242,-2,-0.45 ,226.24 ,2474948,2456016
20140829,447,449,442,445,3489128,1554517376,740310,-2,-0.45 ,158.37 ,1742188,1746940
20140828,446,449,442,448,3118198,1388576512,745062,2,0.45 ,158.37 ,1558221,1559977
20140827,448,452,445,446,3338254,1496332544,746818,-2,-0.45 ,157.30 ,1669383,1668871
20140826,448,450,442,449,3019782,1349413760,746306,1,0.22 ,181.00 ,1508380,1511402
20140825,455,456,446,448,3429686,1547518464,749328,-7,-1.54 ,224.22 ,1715125,1714561
20140822,454,456,450,455,2992988,1356138112,748764,1,0.22 ,133.33 ,1495191,1497797
20140821,454,458,451,454,3406676,1549326464,751370,0,0.00 ,155.21 ,1702087,1704589
20140820,456,458,449,454,3679766,1669886720,753872,-2,-0.44 ,200.45 ,1831127,1848639
20140819,455,458,453,456,3415952,1555744512,771384,1,0.22 ,110.38 ,1706275,1709677
20140818,463,466,455,455,3464324,1595214720,774786,-8,-1.73 ,241.76 ,1732770,1731554
20140815,463,468,459,463,3789174,1755272192,773570,0,0.00 ,196.08 ,1894812,1894362
20140814,471,471,463,463,3535856,1649952512,773120,-8,-1.70 ,172.79 ,1767337,1768519
20140813,474,477,470,471,3394760,1607376640,774302,-3,-0.63 ,148.94 ,1697104,1697656
20140812,477,478,471,474,3376862,1600864384,774854,-3,-0.63 ,148.62 ,1682381,1694481
20140811,476,478,471,477,3372338,1600275968,786954,1,0.21 ,148.62 ,1659513,1712825
20140808,485,486,474,476,3767356,1806787200,840266,-9,-1.86 ,253.16 ,1841925,1925431
20140807,485,487,479,486,5088708,2458353152,923772,1,0.21 ,167.01 ,2544585,2544123
20140806,489,490,484,485,5305918,2583176448,923310,-4,-0.82 ,123.97 ,2652866,2653052
20140805,494,497,486,489,4764332,2342130944,923496,-5,-1.01 ,226.34 ,2381254,2383078
20140804,501,503,492,494,4328196,2158716416,925320,-7,-1.40 ,223.58 ,2162714,2165482
20140801,502,505,497,501,5368516,2690744320,928088,-1,-0.20 ,160.97 ,2684885,2683631
20140731,495,503,494,502,5685836,2834937600,926834,7,1.41 ,182.19 ,2843493,2842343
20140730,496,498,492,495,6189538,3064444416,925684,-1,-0.20 ,121.95 ,3094425,3095113
20140729,494,497,490,496,6212790,3066260736,926372,2,0.40 ,142.86 ,3106714,3106076
20140728,502,504,493,494,5818054,2901518336,925734,-8,-1.59 ,223.12 ,2908514,2909540
20140725,503,507,499,502,6466290,3253875456,926760,-1,-0.20 ,160.32 ,3232818,3233472
20140724,507,509,500,503,5588990,2815965696,927414,-4,-0.79 ,180.00 ,2794086,2794904
20140723,506,512,504,507,7499966,3810153984,928232,1,0.20 ,158.73 ,3750751,3749215
20140722,503,508,501,506,6887140,3474351872,926696,3,0.60 ,139.72 ,3444731,3442409
20140721,498,503,495,503,7084924,3539805440,924374,5,1.00 ,161.62 ,3544033,3540891
20140718,487,498,486,498,7915714,3896577792,921232,11,2.26 ,246.91 ,3961544,3954170
20140717,482,487,480,487,6104842,2948972544,913858,5,1.04 ,145.83 ,3053942,3050900
20140716,481,485,476,482,6206238,2978813184,910816,1,0.21 ,189.08 ,3100747,3105491
20140715,486,488,479,481,6147622,2972680192,915560,-5,-1.03 ,187.89 ,3072991,3074631
20140714,483,491,481,486,5974402,2907490048,917200,3,0.62 ,207.90 ,2988166,2986236
20140711,491,492,481,483,5247438,2547495168,915270,-8,-1.63 ,228.69 ,2620916,2626522
20140710,494,496,488,491,6315406,3106948864,920876,-3,-0.61 ,163.93 ,3156031,3159375
20140709,482,494,481,494,5889336,2867070464,924220,12,2.49 ,270.27 ,2949194,2940142
20140708,486,488,478,482,5921684,2856586240,915168,-4,-0.82 ,209.21 ,2962079,2959605
20140707,483,488,481,486,7966234,3859727872,912694,3,0.62 ,145.53 ,3983898,3982336
20140704,483,487,481,483,6766066,3274903040,911132,0,0.00 ,124.74 ,3381702,3384364
20140703,488,489,481,483,6846216,3318097408,913794,-5,-1.02 ,166.32 ,3422642,3423574
20140702,485,492,484,488,7086024,3455792384,914726,3,0.62 ,165.29 ,3543797,3542227
20140701,486,489,481,485,6939232,3365681152,913156,-1,-0.21 ,166.32 ,3467185,3472047
20140630,483,488,480,486,5742966,2777004800,918018,3,0.62 ,166.67 ,2873805,2869161
20140627,473,483,472,483,6361990,3037981952,913374,10,2.11 ,233.05 ,3179141,3182849
20140626,473,476,470,472,5391286,2551775488,917082,-1,-0.21 ,127.66 ,2698991,2692295
20140625,471,478,470,473,7272526,3449211904,910386,2,0.42 ,170.21 ,3633029,3639497
20140624,469,473,464,471,6490108,3041110272,916854,2,0.43 ,193.97 ,3243895,3246213
20140623,469,473,467,470,6554440,3079622144,919172,1,0.21 ,128.48 ,3278454,3275986
20140620,465,472,464,469,6528656,3057012736,916704,4,0.86 ,172.41 ,3262387,3266269
20140619,463,468,460,465,6624168,3074080256,920586,2,0.43 ,173.91 ,3313234,3310934
20140618,471,473,462,463,6294568,2950193664,918286,-8,-1.70 ,238.10 ,3148086,3146482
20140617,473,477,469,471,5959838,2814883584,916682,-2,-0.42 ,170.58 ,2981152,2978686
20140616,476,477,471,473,4000006,1897548672,914216,-3,-0.63 ,127.39 ,2002811,1997195
20140613,480,485,474,476,7212102,3453098240,908600,-4,-0.83 ,232.07 ,3603926,3608176
20140612,471,482,469,480,6988604,3326459648,912850,9,1.91 ,277.19 ,3494133,3494471
20140611,475,477,467,471,6642044,3127543040,913188,-4,-0.84 ,214.13 ,3320635,3321409
20140610,476,482,472,476,6550374,3121072640,913962,0,0.00 ,211.86 ,3276194,3274180
20140609,475,477,471,476,8141818,3861268992,911948,1,0.21 ,127.39 ,4071236,4070582
20140606,474,478,470,475,7183656,3403947264,911294,1,0.21 ,170.21 ,3590023,3593633
20140605,475,480,472,474,6873994,3273287424,914904,-1,-0.21 ,169.49 ,3435657,3438337
20140604,481,482,473,475,6509658,3109457920,917584,-6,-1.25 ,190.27 ,3256647,3253011
20140603,488,489,479,481,5125260,2481367040,913948,-7,-1.43 ,208.77 ,2562677,2562583
20140530,495,496,485,488,6433570,3157816832,913854,-7,-1.41 ,226.80 ,3211244,3222326
20140529,500,502,493,495,7506946,3737431296,924936,-5,-1.00 ,182.56 ,3748315,3758631
20140528,496,502,494,500,8342266,4158253824,935252,4,0.81 ,161.94 ,4168499,4173767
20140527,499,503,494,496,7638252,3816320512,940520,-3,-0.60 ,182.19 ,3815984,3822268
20140526,488,501,487,499,7326466,3618838016,946804,11,2.25 ,287.47 ,3667219,3659247
20140523,483,490,480,488,6843584,3318207232,938832,5,1.04 ,208.33 ,3424177,3419407
20140522,479,489,478,483,7154576,3456873728,934062,4,0.84 ,230.13 ,3576335,3578241
20140521,469,479,468,479,6236230,2960030464,935968,10,2.13 ,235.04 ,3120802,3115428
20140520,473,476,467,469,6203858,2924517632,930594,-4,-0.85 ,192.72 ,3103910,3099948
20140519,474,479,470,473,6036798,2863433984,926632,-1,-0.21 ,191.49 ,3015289,3021509
20140516,465,476,464,474,6006920,2834609920,932852,9,1.94 ,258.62 ,2997104,3009816
20140515,461,468,460,467,4066668,1888942848,945564,6,1.30 ,173.91 ,2035046,2031622
20140514,464,466,458,461,6028490,2784538880,942140,-3,-0.65 ,174.67 ,3010686,3017804
20140513,466,470,462,464,5948986,2772170496,949258,-2,-0.43 ,173.16 ,2975369,2973617
20140512,468,470,462,466,3799836,1772478592,947506,-2,-0.43 ,173.16 ,1902478,1897358
20140509,464,472,463,468,5412094,2530049536,942386,4,0.86 ,194.38 ,2704740,2707354
20140508,463,466,458,464,5410228,2498525696,945000,1,0.22 ,174.67 ,2709336,2700892
20140507,456,463,454,463,5205108,2384110592,936556,7,1.54 ,198.24 ,2602755,2602353
20140506,452,458,446,456,5251362,2377167360,936154,4,0.88 ,269.06 ,2629169,2622193
20140505,459,461,450,452,4139518,1883421184,929178,-7,-1.53 ,244.44 ,2068784,2070734
20140430,455,462,452,459,5062422,2319648768,931128,4,0.88 ,221.24 ,2534092,2528330
20140429,453,457,450,455,4896176,2221913600,925366,2,0.44 ,155.56 ,2449536,2446640
20140428,450,459,448,453,4308050,1948614912,922470,3,0.67 ,245.54 ,2153126,2154924
20140425,449,454,446,450,4011526,1805127296,924268,1,0.22 ,179.37 ,2003972,2007554
20140424,454,456,448,449,4556660,2057332224,927850,-5,-1.10 ,178.57 ,2276933,2279727
20140423,462,463,454,454,4117006,1887336448,930644,-8,-1.73 ,198.24 ,2055467,2061539
20140422,479,479,461,461,4123498,1936580608,936716,-18,-3.76 ,390.46 ,2060250,2063248
20140421,489,492,475,478,4931936,2398011392,939714,-11,-2.25 ,357.89 ,2460672,2471264
20140419,489,492,487,491,2414392,1182716800,950306,2,0.41 ,102.67 ,1210340,1204052
20140418,481,490,479,489,5238630,2536400896,944018,8,1.66 ,229.65 ,2619470,2619160
20140417,480,483,474,481,5325776,2548185856,943708,1,0.21 ,189.87 ,2663643,2662133
20140416,486,490,478,480,5600706,2704958208,942198,-6,-1.23 ,251.05 ,2800699,2800007
20140415,480,488,477,486,4288442,2070433664,941506,6,1.25 ,230.61 ,2139229,2149213
20140411,483,487,479,479,2504538,1211124352,951490,-4,-0.83 ,167.01 ,1249409,1255129
20140410,474,483,472,483,7035534,3349377536,957210,9,1.90 ,233.05 ,3518831,3516703
20140409,475,478,470,474,6282228,2977030144,955082,-1,-0.21 ,170.21 ,3137028,3145200
20140408,465,478,463,475,6271586,2953597184,963254,10,2.15 ,323.97 ,3138534,3133052
20140404,464,471,462,465,5856972,2735529216,957772,1,0.22 ,194.81 ,2925242,2931730
20140403,462,468,462,464,5635782,2620251392,964260,2,0.43 ,129.87 ,2820810,2814972
20140402,457,465,455,462,5670710,2607673856,958422,5,1.09 ,219.78 ,2837365,2833345
20140401,457,459,451,457,5856084,2663387648,954402,0,0.00 ,177.38 ,2927396,2928688
20140331,474,476,456,457,6803254,3158498560,955694,-17,-3.59 ,438.60 ,3400169,3403085
20140328,470,479,467,474,7335210,3473126400,958610,4,0.85 ,256.96 ,3662502,3672708
20140327,472,478,467,470,6818420,3216828160,968816,-2,-0.42 ,235.55 ,3413183,3405237
20140326,466,474,459,472,6878624,3213067776,960870,6,1.29 ,326.80 ,3440590,3438034
20140325,473,482,464,466,6740438,3190610688,958314,-7,-1.48 ,387.93 ,3369073,3371365
20140324,467,479,466,473,7784982,3678091264,960606,6,1.28 ,278.97 ,3892777,3892205
20140321,482,483,465,467,6325020,2998986496,960034,-15,-3.11 ,387.10 ,3158968,3166052
20140320,476,484,473,482,5334312,2551327744,967118,6,1.26 ,232.56 ,2668115,2666197
20140319,484,486,476,476,6079982,2920805888,965200,-8,-1.65 ,210.08 ,3042104,3037878
20140318,487,492,481,484,6662294,3237392640,960974,-3,-0.62 ,228.69 ,3311306,3350988
20140317,476,493,475,486,5643054,2737671168,1000656,10,2.10 ,378.95 ,2844328,2798726
20140314,479,486,471,476,5907206,2823642112,955054,-3,-0.63 ,318.47 ,2949024,2958182
20140313,470,482,469,479,6314052,3010991872,964212,9,1.91 ,277.19 ,3157896,3156156
20140312,473,477,465,470,7048790,3318530560,962472,-3,-0.63 ,258.06 ,3525385,3523405
20140311,474,483,469,473,6145328,2920775424,960492,-1,-0.21 ,298.51 ,3075706,3069622
20140310,461,474,460,474,6323428,2950784768,954408,13,2.82 ,304.35 ,3161346,3162082
20140307,462,467,458,461,6193692,2868479232,955144,-1,-0.22 ,196.51 ,3092007,3101685
20140306,440,462,440,462,6846844,3101532672,964822,22,5.00 ,500.00 ,3416742,3430102
20140305,435,446,435,440,7212934,3185516544,978182,5,1.15 ,252.87 ,3602383,3610551
20140304,418,437,415,435,6347238,2696763136,986350,17,4.07 ,530.12 ,3185677,3161561
20140303,419,431,418,422,4065368,1726222976,962234,3,0.72 ,311.00 ,2032997,2032371
20140228,399,421,399,419,6354032,2602194944,961608,20,5.01 ,551.38 ,3175479,3178553
20140227,405,407,395,399,6381378,2547500288,964682,-6,-1.48 ,303.80 ,3194702,3186676
20140226,411,416,405,405,6381848,2619809536,956656,-6,-1.46 ,271.60 ,3191527,3190321
20140225,407,416,402,411,6228126,2546019328,955450,4,0.98 ,348.26 ,3120726,3107400
20140224,427,427,406,407,5284708,2201521664,942124,-20,-4.68 ,517.24 ,2644520,2640188
20140221,428,432,421,427,6688418,2851782912,937792,-1,-0.23 ,261.28 ,3340353,3348065
20140220,437,440,424,428,5861560,2518121216,945504,-9,-2.06 ,377.36 ,2933448,2928112
20140219,449,453,435,437,5785390,2568865792,940168,-12,-2.67 ,413.79 ,2890432,2894958
20140218,452,459,445,449,6463214,2916632576,944694,-3,-0.66 ,314.61 ,3234005,3229209
20140217,450,455,440,452,6906618,3092552704,939898,2,0.44 ,340.91 ,3449473,3457145
20140214,448,454,439,452,4341664,1941620096,947570,4,0.89 ,341.69 ,2174528,2167136
20140213,437,452,436,448,5982888,2663330048,940178,11,2.52 ,366.97 ,2993240,2989648
20140212,422,440,418,437,4557500,1964057216,936586,15,3.55 ,526.32 ,2281437,2276063
20140211,433,434,415,422,5557478,2349737216,931212,-11,-2.54 ,457.83 ,2770493,2786985
20140210,441,448,438,438,3332556,1474881408,947704,-3,-0.68 ,228.31 ,1677867,1654689
20140207,428,443,424,441,5954746,2595358976,924526,13,3.04 ,448.11 ,2979406,2975340
20140129,433,440,426,428,4276332,1851235968,920460,-5,-1.15 ,328.64 ,2129617,2146715
20140128,432,442,424,433,5872222,2535455744,937558,1,0.23 ,424.53 ,2934154,2938068
20140127,428,434,420,432,6426956,2742324480,941472,4,0.93 ,333.33 ,3214035,3212921
20140124,434,437,425,428,7005434,3016230912,940358,-6,-1.38 ,282.35 ,3500746,3504688
20140123,419,436,418,434,8497584,3659061504,944300,15,3.58 ,430.62 ,4250895,4246689
20140122,406,420,403,419,5689170,2343376128,940094,13,3.20 ,421.84 ,2844338,2844832
20140121,416,420,403,406,5176458,2135282816,940588,-10,-2.40 ,421.84 ,2588746,2587712
20140120,414,416,413,414,154186,63924956,939554,0,0.00 ,72.64 ,81114,73072
20140117,415,424,413,416,4582288,1917230976,931512,1,0.24 ,266.34 ,2287256,2295032
20140116,405,418,400,415,4195544,1719648128,939288,10,2.47 ,450.00 ,2102713,2092831
20140115,416,418,406,406,4172388,1717185280,929406,-10,-2.40 ,295.57 ,2081352,2091036
20140114,425,426,414,416,4469734,1871198848,939090,-9,-2.12 ,289.86 ,2231832,2237902
20140113,424,427,418,425,4224838,1787371008,945160,1,0.24 ,215.31 ,2114767,2110071
20140110,427,428,420,424,5387748,2282503936,940464,-3,-0.70 ,190.48 ,2691297,2696451
20140109,421,431,420,428,5020336,2142020352,945618,7,1.66 ,261.90 ,2513079,2507257
20140108,420,424,414,421,4779448,2005544448,939796,1,0.24 ,241.55 ,2390055,2389393
20140107,419,425,418,420,4337092,1827435904,939134,1,0.24 ,167.46 ,2166416,2170676
20140106,427,428,417,419,5013332,2118011648,943394,-8,-1.87 ,263.79 ,2506483,2506849
20140103,419,427,415,427,5394340,2271250944,943760,8,1.91 ,289.16 ,2698062,2696278
20140102,418,424,415,421,4521334,1895610752,941976,3,0.72 ,216.87 ,2264135,2257199
20131231,409,423,408,418,3861954,1604011776,935040,9,2.20 ,367.65 ,1943002,1918952
20131230,416,417,406,409,3939564,1619005056,910990,-7,-1.68 ,270.94 ,1965681,1973883
20131227,415,418,409,416,4213078,1741348224,919192,1,0.24 ,220.05 ,2112909,2100169
20131226,407,415,406,415,4198708,1726117760,906452,8,1.97 ,221.67 ,2103540,2095168
20131225,411,412,401,407,3809144,1546702720,898080,-4,-0.97 ,274.31 ,1898940,1910204
20131224,407,411,402,411,4272456,1734580608,909344,4,0.98 ,223.88 ,2147244,2125212
20131223,412,414,403,407,3995516,1634709632,887312,-5,-1.21 ,272.95 ,1994467,2001049
20131220,409,415,403,412,4558918,1862661632,893894,3,0.73 ,297.77 ,2293156,2265762
20131219,424,425,417,422,1509954,636403648,866500,-2,-0.47 ,191.85 ,743753,766201
20131218,421,425,416,424,4380556,1844028544,888948,3,0.71 ,216.35 ,2195753,2184803
20131217,426,429,419,421,4364946,1857394304,877998,-5,-1.17 ,238.66 ,2177805,2187141
20131216,438,439,423,426,4458360,1926508928,887334,-12,-2.74 ,378.25 ,2225226,2233134
20131213,433,442,433,438,4378072,1915756800,895242,5,1.15 ,207.85 ,2188490,2189582
20131212,442,443,431,434,3851840,1683016960,896334,-8,-1.81 ,278.42 ,1918381,1933459
20131211,447,448,432,442,3958492,1743776896,911412,-5,-1.12 ,370.37 ,1975768,1982724
20131210,460,461,443,447,2851168,1289456896,918368,-13,-2.83 ,406.32 ,1430117,1421051
20131209,450,462,449,460,4519764,2069267328,909302,10,2.22 ,289.53 ,2267314,2252450
20131206,448,453,444,450,4120452,1848174976,894438,2,0.45 ,202.70 ,2060813,2059639
20131205,447,452,442,448,4446866,1987802752,893264,1,0.22 ,226.24 ,2228499,2218367
20131204,426,447,424,447,8030016,3524478464,883132,21,4.93 ,542.45 ,4028081,4001935
20131203,430,432,423,426,3493762,1492208512,856986,-4,-0.93 ,212.77 ,1744184,1749578
20131202,425,431,415,430,3410818,1445866624,862380,5,1.18 ,385.54 ,1707765,1703053
20131129,429,432,422,425,4345720,1852342016,857668,-4,-0.93 ,236.97 ,2164825,2180895
20131128,436,441,426,429,4366848,1899143808,873738,-7,-1.61 ,352.11 ,2180788,2186060
20131127,425,436,423,435,4915862,2115616768,879010,10,2.35 ,307.33 ,2464750,2451112
20131126,431,437,418,425,5097814,2182263040,865372,-6,-1.39 ,454.55 ,2548161,2549653
20131125,428,434,424,431,5736644,2453099008,866864,3,0.70 ,235.85 ,2865749,2870895
20131122,416,429,415,428,4846742,2050369280,872010,12,2.88 ,337.35 ,2429953,2416789
20131121,418,426,415,416,4551840,1911845632,858846,-2,-0.48 ,265.06 ,2277090,2274750
20131120,411,423,407,418,4891008,2032362368,856506,7,1.70 ,393.12 ,2444375,2446633
20131119,403,413,402,413,4871862,1984755968,858764,10,2.48 ,273.63 ,2424952,2446910
20131118,396,403,395,403,2730086,1087743104,880722,7,1.77 ,202.53 ,1380785,1349301
20131115,383,399,382,396,4591808,1794031744,849238,13,3.39 ,445.03 ,2293228,2298580
20131114,378,385,375,383,4935386,1870170880,854590,5,1.32 ,266.67 ,2457933,2477453
20131113,390,391,382,387,3087764,1193072256,874110,-3,-0.77 ,235.60 ,1550532,1537232
20131112,408,410,387,390,4177344,1675456640,860810,-18,-4.41 ,594.32 ,2087671,2089673
20131111,404,412,402,409,4546338,1848813312,862812,5,1.24 ,248.76 ,2277824,2268514
20131108,404,406,400,404,1833510,738379136,853502,0,0.00 ,150.00 ,911280,922230
20131107,413,416,403,404,4293580,1760765440,864452,-9,-2.18 ,322.58 ,2147655,2145925
20131106,418,419,408,413,4412084,1823965440,862722,-5,-1.20 ,269.61 ,2206713,2205371
20131105,424,428,414,418,4569608,1927454336,861380,-6,-1.42 ,338.16 ,2289045,2280563
20131104,415,425,413,424,4805404,2013912320,852898,9,2.17 ,290.56 ,2404500,2400904
20131101,400,417,396,415,4353516,1774931840,849302,15,3.75 ,530.30 ,2172544,2180972
20131031,401,407,398,400,3325842,1337956480,857730,-1,-0.25 ,226.13 ,1666398,1659444
20131030,405,410,396,401,3604022,1455269504,850776,-4,-0.99 ,353.54 ,1796546,1807476
20131029,399,409,397,405,4253150,1718800768,861706,6,1.50 ,302.27 ,2127509,2125641
20131028,396,402,389,399,3376842,1335522816,859838,3,0.76 ,334.19 ,1690018,1686824
20131025,392,397,386,396,3614584,1418635648,856644,4,1.02 ,284.97 ,1804067,1810517
20131024,400,402,390,392,3413964,1347806848,863094,-8,-2.00 ,307.69 ,1715563,1698401
20131023,410,412,399,401,3802240,1541554432,845932,-9,-2.20 ,325.81 ,1900399,1901841
20131022,405,411,400,410,3554768,1442179328,847374,5,1.23 ,275.00 ,1781477,1773291
20131021,404,406,396,406,3338118,1343194112,839188,2,0.50 ,252.53 ,1658911,1679207
20131018,417,417,414,415,139788,58122120,859484,-2,-0.48 ,72.46 ,70736,69052
20131017,409,422,406,417,3897898,1621458560,857800,8,1.96 ,394.09 ,1949999,1947899
20131016,412,414,406,413,2554896,1046694144,855700,1,0.24 ,197.04 ,1280801,1274095
20131015,410,415,406,412,3927438,1611702528,848994,2,0.49 ,221.67 ,1969472,1957966
20131014,409,412,405,411,3368546,1376747648,837488,2,0.49 ,172.84 ,1686494,1682052
20131011,413,419,406,409,3528892,1454176256,833046,-4,-0.97 ,320.20 ,1765788,1763104
20131010,408,414,402,413,3457884,1411050112,830362,5,1.23 ,298.51 ,1730060,1727824
20131009,406,411,404,408,3158582,1286869504,828126,2,0.49 ,173.27 ,1582257,1576325
20131008,400,408,398,406,3306670,1336313856,822194,6,1.50 ,251.26 ,1657006,1649664
20130930,402,406,396,400,2921554,1173714432,814852,-2,-0.50 ,252.53 ,1458864,1462690
20130927,400,403,396,402,2966272,1183979648,818678,2,0.50 ,176.77 ,1480745,1485527
20130926,398,400,393,400,2750242,1091247616,823460,2,0.50 ,178.12 ,1376262,1373980
20130925,388,398,386,398,2919800,1148055040,821178,10,2.58 ,310.88 ,1461472,1458328
20130924,398,401,385,388,2632822,1036419776,818034,-10,-2.51 ,415.58 ,1317989,1314833
20130923,405,407,395,398,2841722,1137029120,814878,-7,-1.73 ,303.80 ,1423541,1418181
20130918,398,407,392,405,2801710,1120377088,809518,7,1.76 ,382.65 ,1397110,1404600
20130917,399,404,395,398,2702536,1077704960,817008,-1,-0.25 ,227.85 ,1350496,1352040
20130916,395,402,392,399,2898066,1153208576,818552,4,1.01 ,255.10 ,1452735,1445331
20130913,401,407,393,395,2933464,1172253824,811148,-6,-1.50 ,356.23 ,1452643,1480821
20130912,395,403,394,401,3188102,1271083136,839326,6,1.52 ,228.43 ,1598830,1589272
20130911,390,397,387,395,3057790,1199198720,829768,5,1.28 ,258.40 ,1533054,1524736
20130910,379,392,378,390,2978614,1149630976,821450,11,2.90 ,370.37 ,1489922,1488692
20130909,376,380,370,379,2944788,1105599488,820220,3,0.80 ,270.27 ,1473348,1471440
20130906,378,382,373,376,3418582,1291374208,818312,-2,-0.53 ,241.29 ,1709857,1708725
20130905,363,379,363,378,3206626,1192597248,817180,15,4.13 ,440.77 ,1602521,1604105
20130904,365,371,362,363,3207438,1175505024,818764,-2,-0.55 ,248.62 ,1606376,1601062
20130903,352,367,350,365,3345184,1200763264,813450,13,3.69 ,485.71 ,1680581,1664603
20130902,345,354,342,352,3902218,1358411904,797472,7,2.03 ,350.88 ,1949265,1952953
20130830,340,347,335,345,4743498,1620668288,801160,5,1.47 ,358.21 ,2351422,2392076
20130829,354,360,339,340,5100008,1785567232,841814,-14,-3.95 ,619.47 ,2564328,2535680
20130828,350,358,343,354,4824236,1690700928,813166,4,1.14 ,437.32 ,2412798,2411438
20130827,351,351,340,350,4803570,1664153600,811806,-1,-0.28 ,323.53 ,2403532,2400038
20130826,356,363,347,351,4542690,1612712192,808312,-5,-1.40 ,461.10 ,2272522,2270168
20130823,364,366,352,356,4645214,1661644672,805958,-8,-2.20 ,397.73 ,2318340,2326874
20130822,366,370,360,364,4798594,1748725632,814492,-2,-0.55 ,277.78 ,2404575,2394019
20130821,358,368,357,365,4875304,1769578496,803936,7,1.96 ,308.12 ,2437223,2438081
20130820,371,372,353,358,4758066,1711003520,804794,-13,-3.50 ,538.24 ,2375739,2382327
20130819,373,376,367,371,5305756,1968855296,811382,-2,-0.54 ,245.23 ,2624367,2681389
20130816,370,375,368,375,3526760,1310419968,868404,5,1.35 ,190.22 ,1787194,1739566
20130815,376,377,368,370,5020728,1870856448,820776,-6,-1.60 ,244.57 ,2511506,2509222
20130814,377,386,374,376,4948818,1878755072,818492,-1,-0.27 ,320.86 ,2474216,2474602
20130813,375,381,372,377,5070778,1908336000,818878,2,0.53 ,241.94 ,2536325,2534453
20130812,370,379,369,375,3491538,1305348096,817006,5,1.35 ,271.00 ,1750521,1741017
20130809,356,372,354,370,4636602,1696574592,807502,14,3.93 ,508.47 ,2307100,2329502
20130808,340,356,338,356,4048248,1407848448,829904,16,4.71 ,532.54 ,2021217,2027031
20130807,342,347,337,340,4641162,1588973696,835718,-2,-0.58 ,296.74 ,2320271,2320891
20130806,333,347,327,342,4837506,1634337024,836338,9,2.70 ,611.62 ,2425881,2411625
20130805,340,342,333,333,4360204,1469264256,822082,-7,-2.06 ,270.27 ,2181208,2178996
20130802,350,357,338,340,3696458,1289286912,819870,-10,-2.86 ,562.13 ,1842779,1853679
20130801,347,353,343,350,4037176,1408330880,830770,3,0.86 ,291.55 ,2020116,2017060
20130731,363,367,344,347,3617658,1284296192,827714,-16,-4.41 ,668.60 ,1818106,1799552
20130730,365,376,358,363,3775360,1384288384,809160,-2,-0.55 ,502.79 ,1889114,1886246
20130729,361,370,356,365,3283708,1192056960,806292,4,1.11 ,393.26 ,1643551,1640157
20130726,357,365,351,361,2469754,885096704,802898,4,1.12 ,398.86 ,1232098,1237656
20130725,348,360,347,357,1601352,567488320,808456,9,2.59 ,374.64 ,798731,802621
20130724,346,353,345,348,1896158,662244992,812346,2,0.58 ,231.88 ,945158,951000
20130723,360,361,343,346,2008418,705450624,818188,-14,-3.89 ,524.78 ,1005721,1002697
20130722,362,369,358,360,1991552,724930368,815164,-2,-0.55 ,307.26 ,997477,994075
20130719,352,362,351,362,3028296,1082453248,811762,10,2.84 ,313.39 ,1511554,1516742
20130718,348,356,345,352,2707468,950005184,816950,4,1.15 ,318.84 ,1353817,1353651
20130717,363,364,346,348,2697716,960165120,816784,-15,-4.13 ,520.23 ,1349540,1348176
20130716,366,367,354,363,2178456,786638528,815420,-3,-0.82 ,367.23 ,1090390,1088066
20130715,365,373,364,366,2197762,809024640,813096,1,0.27 ,247.25 ,1099286,1098476
20130712,359,368,354,365,2227876,803584128,812286,6,1.67 ,395.48 ,1104566,1123310
20130711,364,369,357,359,1831662,663252992,831030,-5,-1.37 ,336.13 ,920331,911331
20130710,366,370,360,364,2317104,845938560,822030,-2,-0.55 ,277.78 ,1155544,1161560
20130709,371,372,362,366,2252642,825193088,828046,-5,-1.35 ,276.24 ,1127845,1124797
20130708,356,372,355,371,1717462,626355072,824998,15,4.21 ,478.87 ,861024,856438
20130705,358,364,355,356,1942428,697432576,820412,-2,-0.56 ,253.52 ,975208,967220
20130704,361,363,353,358,2075660,741573248,812424,-3,-0.83 ,283.29 ,1044891,1030769
20130703,354,361,353,361,2016310,720094400,798302,7,1.98 ,226.63 ,1008496,1007814
20130702,352,363,350,354,2225854,792788928,797620,2,0.57 ,371.43 ,1115174,1110680
20130701,345,354,340,352,1840016,635910784,793126,7,2.03 ,411.76 ,924353,915663
20130628,334,347,333,345,1776198,604932928,784436,11,3.29 ,420.42 ,890913,885285
20130627,327,336,323,334,1995820,658619328,778808,7,2.14 ,402.48 ,998907,996913
20130626,329,334,325,327,2251360,741215232,776814,-2,-0.61 ,276.92 ,1121144,1130216
20130625,331,335,326,329,2066276,682282304,785886,-2,-0.60 ,276.07 ,1030995,1035281
20130624,333,336,327,331,2049854,679725440,790172,-2,-0.60 ,275.23 ,1029183,1020671
20130621,327,340,326,333,2129878,712061312,781660,6,1.83 ,429.45 ,1055756,1074122
20130620,320,330,318,327,1937240,627816064,800026,7,2.19 ,377.36 ,964216,973024
20130619,322,325,317,320,2004918,643582592,808834,-2,-0.62 ,252.37 ,1002601,1002317
20130618,311,323,309,322,1936850,614030848,808550,11,3.54 ,453.07 ,972250,964600
20130617,307,314,303,311,1717494,532007360,800900,4,1.30 ,363.04 ,859996,857498
20130614,308,312,303,307,1849538,568921408,798402,-1,-0.32 ,297.03 ,921069,928469
20130613,287,308,287,308,1702836,507911520,805802,21,7.32 ,731.71 ,855614,847222
20130607,288,293,285,287,1846390,533948896,797410,-1,-0.35 ,280.70 ,918745,927645
20130606,290,298,286,288,2105834,614307968,806310,-2,-0.69 ,419.58 ,1054564,1051270
20130605,283,292,282,290,3246526,934263360,803016,7,2.47 ,354.61 ,1629423,1617103
20130604,266,283,264,283,1996838,546258176,790696,17,6.39 ,719.70 ,996607,1000231
20130603,269,271,264,266,1756022,468892032,794320,-3,-1.12 ,265.15 ,882112,873910
20130531,260,271,259,269,2014236,534180928,786118,9,3.46 ,463.32 ,1007094,1007142
20130530,251,261,251,260,2055566,524290368,786166,9,3.59 ,398.41 ,1030098,1025468
20130529,248,253,245,251,1916190,476159936,781536,3,1.21 ,326.53 ,955385,960805
20130528,243,251,241,248,1890938,465224128,786956,5,2.06 ,414.94 ,947881,943057
20130527,237,246,237,242,2314494,561622912,782132,5,2.11 ,379.75 ,1157414,1157080
20130524,230,238,229,236,2354886,550184960,781798,6,2.61 ,393.01 ,1173326,1181560
20130523,226,233,225,230,2241842,512647104,790032,4,1.77 ,355.56 ,1115372,1126470
20130522,219,228,218,226,1931092,432507136,801130,7,3.20 ,458.72 ,979778,951314
20130521,214,221,213,218,1378446,299279360,772666,4,1.87 ,375.59 ,690179,688267
20130520,218,221,212,214,2489802,538372544,770754,-4,-1.83 ,424.53 ,1248663,1241139
20130517,212,218,210,218,2263608,484293600,763230,6,2.83 ,380.95 ,1126202,1137406
20130516,216,218,209,212,3077304,655868480,774434,-4,-1.85 ,430.62 ,1539953,1537351
20130515,217,218,213,216,2741428,589705280,771832,-1,-0.46 ,234.74 ,1376818,1364610
20130514,220,221,214,217,3364260,729690496,759624,-3,-1.36 ,327.10 ,1684087,1680173
20130513,219,222,216,220,2332096,510821632,755710,1,0.46 ,277.78 ,1168516,1163580
20130510,221,223,215,219,5263382,1150962944,750774,-2,-0.90 ,372.09 ,2600841,2662541
20130509,224,229,220,221,5045460,1129524224,812474,-3,-1.34 ,409.09 ,2527303,2518157
20130508,232,233,224,224,4235294,962533120,803328,-8,-3.45 ,401.79 ,2118044,2117250
20130507,236,238,230,232,2248324,524263168,802534,-4,-1.69 ,347.83 ,1127235,1121089
20130506,236,240,234,238,725028,171949248,796388,2,0.85 ,256.41 ,363308,361720
20130503,228,238,227,236,2557578,592032256,794800,8,3.51 ,484.58 ,1273179,1284399
20130502,233,235,225,228,2175736,498811488,806020,-5,-2.15 ,444.44 ,1085020,1090716
20130428,228,236,227,233,1415112,328277760,811716,5,2.19 ,396.48 ,703700,711412
20130427,227,231,223,224,985682,224367056,819428,-3,-1.32 ,358.74 ,488759,496923
20130426,226,231,223,227,3240734,735358336,827592,1,0.44 ,358.74 ,1623717,1617017
20130425,232,233,221,226,3067662,694478144,820892,-6,-2.59 ,542.99 ,1534417,1533245
20130424,244,244,230,232,3694070,872034752,819720,-12,-4.92 ,608.70 ,1846523,1847547
20130423,243,248,239,244,2897120,703638848,820744,1,0.41 ,376.57 ,1447792,1449328
20130422,254,255,243,243,3150644,779120192,822280,-11,-4.33 ,493.83 ,1576771,1573873
20130419,268,269,254,254,3027820,787536320,819382,-14,-5.22 ,590.55 ,1508645,1519175
20130418,280,282,268,268,2833612,778012032,829912,-12,-4.29 ,522.39 ,1417215,1416397
20130417,269,285,267,280,2438904,675608384,829094,11,4.09 ,674.16 ,1214460,1224444
20130416,272,277,268,269,2591124,705778240,839078,-3,-1.10 ,335.82 ,1291382,1299742
20130415,277,279,268,272,2293058,628689024,847438,-5,-1.81 ,410.45 ,1150346,1142712
20130412,281,282,276,277,2344684,653687808,839804,-4,-1.42 ,217.39 ,1169030,1175654
20130411,284,285,276,281,2422696,681210752,846428,-3,-1.06 ,326.09 ,1211061,1211635
20130410,275,286,275,284,2427710,680328000,847002,9,3.27 ,400.00 ,1218827,1208883
20130409,266,279,265,275,2751720,750378944,837058,9,3.38 ,528.30 ,1372072,1379648
20130408,251,268,251,266,2174316,570631168,844634,15,5.98 ,677.29 ,1086229,1088087
20130407,245,254,245,251,2102552,522735232,846492,6,2.45 ,367.35 ,1051320,1051232
20130403,250,259,240,245,2778024,687338560,846404,-5,-2.00 ,791.67 ,1381974,1396050
20130402,236,253,235,250,2291522,558929856,860480,14,5.93 ,765.96 ,1150184,1141338
20130401,236,240,229,236,2597314,610001024,851634,0,0.00 ,480.35 ,1300025,1297289
20130329,246,249,234,236,2535618,605819264,848898,-10,-4.07 ,641.03 ,1262633,1272985
20130328,258,260,245,246,2325792,586293632,859250,-12,-4.65 ,612.24 ,1161788,1164004
20130327,259,273,258,258,2274104,603403712,861466,-1,-0.39 ,581.40 ,1132572,1141532
20130326,247,264,244,259,2251874,570959744,870426,12,4.86 ,819.67 ,1128339,1123535
20130325,249,256,246,247,2301584,574543936,865622,-2,-0.80 ,406.50 ,1151358,1150226
20130322,241,251,240,249,1992716,491118304,864490,8,3.32 ,458.33 ,987989,1004727
20130321,232,242,227,241,1793292,416486944,881228,9,3.88 ,660.79 ,898943,894349
20130320,234,239,229,232,3177650,739418816,876634,-2,-0.85 ,436.68 ,1591671,1585979
20130319,222,238,219,234,2875432,659154368,870942,12,5.41 ,867.58 ,1442411,1433021
20130318,243,245,223,223,3127106,725144576,861552,-20,-8.23 ,986.55 ,1564467,1562639
20130315,242,246,240,243,5137132,1250110848,859724,1,0.41 ,250.00 ,2574649,2562483
20130314,241,247,237,242,4517162,1090941312,847558,1,0.41 ,421.94 ,2261524,2255638
20130313,239,245,236,241,4485634,1077988608,841672,2,0.84 ,381.36 ,2244250,2241384
20130312,254,255,239,239,4895276,1210350848,838806,-15,-5.91 ,669.46 ,2453378,2441898
20130311,260,263,252,254,2442612,629979392,827326,-6,-2.31 ,436.51 ,1225852,1216760
20130308,259,263,257,260,2390398,620843008,818234,1,0.39 ,233.46 ,1189441,1200957
20130307,265,266,259,259,2561520,672460736,829750,-6,-2.26 ,270.27 ,1284021,1277499
20130306,265,268,259,265,2128352,558963776,823228,0,0.00 ,347.49 ,1066167,1062185
20130305,267,268,261,265,2419410,639112000,819246,-2,-0.75 ,268.20 ,1213443,1205967
20130304,271,274,262,267,2436016,650966464,811770,-4,-1.48 ,458.02 ,1219991,1216025
20130301,272,276,267,271,2313304,627234368,807804,-1,-0.37 ,337.08 ,1152441,1160863
20130228,270,275,267,272,2319306,629167680,816226,2,0.74 ,299.63 ,1161710,1157596
20130227,269,272,265,270,2389838,641670080,812112,1,0.37 ,264.15 ,1196338,1193500
20130226,284,287,268,269,2631496,733470144,809274,-15,-5.28 ,708.96 ,1317597,1313899
20130225,283,287,280,284,2333984,661800960,805576,1,0.35 ,250.00 ,1169202,1164782
20130222,283,287,281,283,2312950,657433152,801156,0,0.00 ,213.52 ,1152835,1160115
20130221,279,286,272,283,2303446,640784384,808436,4,1.43 ,514.71 ,1142509,1160937
20130220,285,286,278,279,2432594,688384896,826864,-6,-2.11 ,287.77 ,1205288,1227306
20130219,287,289,283,285,2121114,606850496,848882,-2,-0.70 ,212.01 ,1100179,1020935
20130218,280,292,279,287,2692946,775971200,769638,7,2.50 ,465.95 ,1348461,1344485
20130217,276,282,276,280,2162454,605369024,765662,4,1.45 ,217.39 ,1084072,1078382
20130216,275,280,272,276,1964554,543976384,759972,1,0.36 ,294.12 ,983960,980594
20130208,274,278,273,275,403222,111129264,756606,1,0.36 ,183.15 ,190948,212274
20130207,273,276,270,274,817332,223101760,777932,1,0.37 ,222.22 ,400806,416526
20130206,267,276,266,273,1592490,433696544,793652,6,2.25 ,375.94 ,792706,799784
20130205,261,270,256,267,2396514,627947456,800730,6,2.30 ,546.88 ,1198812,1197702
20130204,262,267,258,261,2256600,590807616,799620,-1,-0.38 ,348.84 ,1129620,1126980
20130201,261,265,256,262,2355142,612804224,796980,1,0.38 ,351.56 ,1179150,1175992
20130131,262,265,257,261,2409994,626453376,793822,-1,-0.38 ,311.28 ,1205564,1204430
20130130,264,267,257,262,2361846,618071680,792688,-2,-0.76 ,389.11 ,1182745,1179101
20130129,274,275,263,264,2455536,658054144,789044,-10,-3.65 ,456.27 ,1229138,1226398
20130128,285,285,273,274,2126660,590952512,786304,-11,-3.86 ,439.56 ,1065553,1061107
20130125,275,289,274,285,2312562,654668864,781858,10,3.64 ,547.45 ,1159521,1153041
20130124,268,277,264,275,2305868,625172032,775378,7,2.61 ,492.42 ,1153823,1152045
20130123,276,276,268,268,2392958,650668672,773600,-8,-2.90 ,298.51 ,1199298,1193660
20130122,282,286,274,276,2127270,592630464,767962,-6,-2.13 ,437.96 ,1059578,1067692
20130121,280,287,276,282,2161864,609125568,776076,2,0.71 ,398.55 ,1082501,1079363
20130118,281,285,277,280,2254878,634200768,772938,-1,-0.36 ,288.81 ,1129790,1125088
20130117,287,290,280,281,2283514,652677888,768236,-6,-2.09 ,357.14 ,1143320,1140194
20130116,291,300,282,287,2303558,665574080,765110,-4,-1.37 ,638.30 ,1153196,1150362
20130115,289,296,287,291,2301774,672319488,762276,2,0.69 ,313.59 ,1153960,1147814
20130114,272,292,271,289,2364990,669666496,756130,17,6.25 ,774.91 ,1184370,1180620
20130111,271,276,268,272,2204750,598040256,752380,1,0.37 ,298.51 ,1106368,1098382
20130110,271,279,266,271,2257662,615486592,744394,0,0.00 ,488.72 ,1129084,1128578
20130109,273,276,264,271,2227434,601300416,743888,-2,-0.73 ,454.55 ,1120442,1106992
20130108,279,280,271,273,2298698,630506048,730438,-6,-2.15 ,332.10 ,1157435,1141263
20130107,283,288,278,279,2162672,613463296,714266,-4,-1.41 ,359.71 ,1088696,1073976
20130106,290,290,281,283,2266404,647279360,699546,-7,-2.41 ,320.28 ,1140296,1126108
20130105,291,294,286,290,2163912,626397120,685358,-1,-0.34 ,279.72 ,1108663,1055249
20130104,291,297,289,291,1748694,513033888,631944,0,0.00 ,276.82 ,885059,863635
20121231,288,295,284,291,1907478,553443584,610520,3,1.04 ,387.32 ,966686,940792
20121228,293,294,283,288,1889098,542289408,584626,-5,-1.71 ,388.69 ,950447,938651
20121227,301,302,286,293,1902538,557206720,572830,-8,-2.66 ,559.44 ,975832,926706
20121226,294,305,293,301,1856974,553565248,523704,7,2.38 ,409.56 ,932191,924783
20121225,293,297,286,294,1944718,566620160,516296,1,0.34 ,384.62 ,982013,962705
20121224,297,302,291,293,1989218,590961600,496988,-4,-1.35 ,378.01 ,1006523,982695
20121221,292,300,292,297,1774196,525525408,473160,5,1.71 ,273.97 ,892078,882118
20121220,290,295,287,292,1600940,465888608,463200,2,0.69 ,278.75 ,812271,788669
20121219,294,298,289,290,1697436,498099296,439598,-4,-1.36 ,311.42 ,866087,831349
20121218,302,304,293,294,1411150,421921760,404860,-8,-2.65 ,375.43 ,711719,699431
20121217,301,303,296,302,1381962,414250816,392572,1,0.33 ,236.49 ,711527,670435
20121214,297,303,294,301,1239996,370412736,351480,4,1.35 ,306.12 ,649734,590262
20121213,295,298,287,297,1225604,357299776,292008,2,0.68 ,383.28 ,632871,592733
20121212,300,300,292,295,1043662,308810784,251870,-5,-1.67 ,273.97 ,528874,514788
20121211,308,310,296,300,1198022,364189920,237784,-8,-2.60 ,472.97 ,614014,584008
20121210,317,320,307,308,984474,309162848,207778,-9,-2.84 ,423.45 ,513118,471356
20121207,314,320,309,317,1047736,329867776,166016,3,0.96 ,355.99 ,526993,520743
20121206,318,320,313,314,787096,249428288,159766,-4,-1.26 ,223.64 ,400334,386762
20121205,333,335,318,318,786214,255819696,146194,-15,-4.50 ,534.59 ,400154,386060
20121204,338,341,328,333,774494,259089504,132100,-5,-1.48 ,396.34 ,401207,373287
20121203,348,349,338,338,736886,253354512,104180,-10,-2.87 ,325.44 ,383986,352900
20121130,345,350,339,348,346588,119412552,73094,3,0.87 ,324.48 ,177985,168603
20121129,350,352,342,345,346676,120197256,63712,-5,-1.43 ,292.40 ,175551,171125
20121128,360,361,347,350,245816,86717000,59286,-10,-2.78 ,403.46 ,128425,117391
20121127,365,366,356,360,82316,29729610,48252,-5,-1.37 ,280.90 ,48001,34315
20121126,360,367,355,365,66222,23893050,34566,5,1.39 ,338.03 ,32704,33518
20121123,363,368,357,360,65648,23826186,35380,-3,-0.83 ,308.12 ,33351,32297
20121122,357,365,353,363,65702,23650534,34326,6,1.68 ,339.94 ,33706,31996
20121121,343,357,340,357,57690,20128752,32616,14,4.08 ,500.00 ,29418,28272
20121120,336,343,332,343,68684,23240178,31470,7,2.08 ,331.33 ,35753,32931